# added postag entries
#-------------------------------------------------------------------------------
# Do not add words here, but report them to languagetool@taaltik.nl
#-------------------------------------------------------------------------------
aandeelhoudersbetrokkenheid	aandeelhoudersbetrokkenheid	ZNW:EKV:DE_
aangeschotenheid	aangeschotenheid	ZNW:EKV:DE_
aanpasbaarheid	aanpasbaarheid	ZNW:EKV:DE_
aanraakbaarheid	aanraakbaarheid	ZNW:EKV:DE_
aansprekendheid	aansprekendheid	ZNW:EKV:DE_
aanvullendheid	aanvullendheid	ZNW:EKV:DE_
abruptheid	abruptheid	ZNW:EKV:DE_
abstractheid	abstractheid	ZNW:EKV:DE_
absurdheid	absurdheid	ZNW:EKV:DE_
accuraatheid	accuraatheid	ZNW:EKV:DE_
achterstalligheid	achterstalligheid	ZNW:EKV:DE_
ademloosheid	ademloosheid	ZNW:EKV:DE_
adequaatheid	adequaatheid	ZNW:EKV:DE_
afgrijslijkheid	afgrijslijkheid	ZNW:EKV:DE_
afhoudendheid	afhoudendheid	ZNW:EKV:DE_
afleesbaarheid	afleesbaarheid	ZNW:EKV:DE_
afleidbaarheid	afleidbaarheid	ZNW:EKV:DE_
afsluitbaarheid	afsluitbaarheid	ZNW:EKV:DE_
afstotelijkheid	afstotelijkheid	ZNW:EKV:DE_
afstudeerplechtigheid	afstudeerplechtigheid	ZNW:EKV:DE_
aftapbaarheid	aftapbaarheid	ZNW:EKV:DE_
aftelbaarheid	aftelbaarheid	ZNW:EKV:DE_
afwachtendheid	afwachtendheid	ZNW:EKV:DE_
ambtelijkheid	ambtelijkheid	ZNW:EKV:DE_
anti-verkoudheid	anti-verkoudheid	ZNW:EKV:DE_
anti-vermoeidheid	anti-vermoeidheid	ZNW:EKV:DE_
anti-waarheid	anti-waarheid	ZNW:EKV:DE_
arbeidsloosheid	arbeidsloosheid	ZNW:EKV:DE_
attentheid	attentheid	ZNW:EKV:DE_
authentiekheid	authentiekheid	ZNW:EKV:DE_
baanonzekerheid	baanonzekerheid	ZNW:EKV:DE_
baardloosheid	baardloosheid	ZNW:EKV:DE_
barheid	barheid	ZNW:EKV:DE_
basistaalvaardigheid	basistaalvaardigheid	ZNW:EKV:DE_
bazigheid	bazigheid	ZNW:EKV:DE_
bedrijfsaangelegenheid	bedrijfsaangelegenheid	ZNW:EKV:DE_
beeldloosheid	beeldloosheid	ZNW:EKV:DE_
begeerteloosheid	begeerteloosheid	ZNW:EKV:DE_
behandelbaarheid	behandelbaarheid	ZNW:EKV:DE_
beheerbaarheid	beheerbaarheid	ZNW:EKV:DE_
behoefteloosheid	behoefteloosheid	ZNW:EKV:DE_
bekostigingsverantwoordelijkheid	bekostigingsverantwoordelijkheid	ZNW:EKV:DE_
belastingplichtigheid	belastingplichtigheid	ZNW:EKV:DE_
beleefbaarheid	beleefbaarheid	ZNW:EKV:DE_
beleggerswijsheid	beleggerswijsheid	ZNW:EKV:DE_
beleidsdoelmatigheid	beleidsdoelmatigheid	ZNW:EKV:DE_
beloopbaarheid	beloopbaarheid	ZNW:EKV:DE_
benaderbaarheid	benaderbaarheid	ZNW:EKV:DE_
benieuwdheid	benieuwdheid	ZNW:EKV:DE_
benodigdheid	benodigdheid	ZNW:EKV:DE_
beproefdheid	beproefdheid	ZNW:EKV:DE_
berijdbaarheid	berijdbaarheid	ZNW:EKV:DE_
beroepsaangelegenheid	beroepsaangelegenheid	ZNW:EKV:DE_
beschavingsloosheid	beschavingsloosheid	ZNW:EKV:DE_
besluitloosheid	besluitloosheid	ZNW:EKV:DE_
bespeelbaarheid	bespeelbaarheid	ZNW:EKV:DE_
bestuurdersveiligheid	bestuurdersveiligheid	ZNW:EKV:DE_
bestuursaangelegenheid	bestuursaangelegenheid	ZNW:EKV:DE_
bestuursloosheid	bestuursloosheid	ZNW:EKV:DE_
beveiligingsverantwoordelijkheid	beveiligingsverantwoordelijkheid	ZNW:EKV:DE_
bevindelijkheid	bevindelijkheid	ZNW:EKV:DE_
bewaarbaarheid	bewaarbaarheid	ZNW:EKV:DE_
bewerkbaarheid	bewerkbaarheid	ZNW:EKV:DE_
bezitsloosheid	bezitsloosheid	ZNW:EKV:DE_
bezitterigheid	bezitterigheid	ZNW:EKV:DE_
bloederigheid	bloederigheid	ZNW:EKV:DE_
blogmoeheid	blogmoeheid	ZNW:EKV:DE_
bloheid	bloheid	ZNW:EKV:DE_
blootheid	blootheid	ZNW:EKV:DE_
bolheid	bolheid	ZNW:EKV:DE_
boomrijpheid	boomrijpheid	ZNW:EKV:DE_
bouwrijpheid	bouwrijpheid	ZNW:EKV:DE_
bouwvaardigheid	bouwvaardigheid	ZNW:EKV:DE_
brandwerendheid	brandwerendheid	ZNW:EKV:DE_
buiigheid	buiigheid	ZNW:EKV:DE_
burgeraangelegenheid	burgeraangelegenheid	ZNW:EKV:DE_
collegeaangelegenheid	collegeaangelegenheid	ZNW:EKV:DE_
commandantenverantwoordelijkheid	commandantenverantwoordelijkheid	ZNW:EKV:DE_
composteerbaarheid	composteerbaarheid	ZNW:EKV:DE_
contactloosheid	contactloosheid	ZNW:EKV:DE_
contextloosheid	contextloosheid	ZNW:EKV:DE_
contracteerbaarheid	contracteerbaarheid	ZNW:EKV:DE_
contractloosheid	contractloosheid	ZNW:EKV:DE_
coolheid	coolheid	ZNW:EKV:DE_
coulantheid	coulantheid	ZNW:EKV:DE_
courantheid	courantheid	ZNW:EKV:DE_
cultuurloosheid	cultuurloosheid	ZNW:EKV:DE_
cyberveiligheid	cyberveiligheid	ZNW:EKV:DE_
dadelijkheid	dadelijkheid	ZNW:EKV:DE_
deeltijdwerkloosheid	deeltijdwerkloosheid	ZNW:EKV:DE_
deelwaarheid	deelwaarheid	ZNW:EKV:DE_
desolaatheid	desolaatheid	ZNW:EKV:DE_
dienstaangelegenheid	dienstaangelegenheid	ZNW:EKV:DE_
diepgaandheid	diepgaandheid	ZNW:EKV:DE_
doelveiligheid	doelveiligheid	ZNW:EKV:DE_
doorleefdheid	doorleefdheid	ZNW:EKV:DE_
doorzoekbaarheid	doorzoekbaarheid	ZNW:EKV:DE_
dorpsaangelegenheid	dorpsaangelegenheid	ZNW:EKV:DE_
dorstloosheid	dorstloosheid	ZNW:EKV:DE_
doseerbaarheid	doseerbaarheid	ZNW:EKV:DE_
douaneaangelegenheid	douaneaangelegenheid	ZNW:EKV:DE_
draaglijkheid	draaglijkheid	ZNW:EKV:DE_
drachtigheid	drachtigheid	ZNW:EKV:DE_
drempelloosheid	drempelloosheid	ZNW:EKV:DE_
drievoudigheid	drievoudigheid	ZNW:EKV:DE_
drinkbaarheid	drinkbaarheid	ZNW:EKV:DE_
droevigheid	droevigheid	ZNW:EKV:DE_
druilerigheid	druilerigheid	ZNW:EKV:DE_
duikveiligheid	duikveiligheid	ZNW:EKV:DE_
dwarsigheid	dwarsigheid	ZNW:EKV:DE_
eenmansaangelegenheid	eenmansaangelegenheid	ZNW:EKV:DE_
eenmansminderheid	eenmansminderheid	ZNW:EKV:DE_
eindhardheid	eindhardheid	ZNW:EKV:DE_
eliteaangelegenheid	eliteaangelegenheid	ZNW:EKV:DE_
emotieloosheid	emotieloosheid	ZNW:EKV:DE_
energie-werkelijkheid	energie-werkelijkheid	ZNW:EKV:DE_
energieloosheid	energieloosheid	ZNW:EKV:DE_
enkelvoudigheid	enkelvoudigheid	ZNW:EKV:DE_
ergheid	ergheid	ZNW:EKV:DE_
ernstigheid	ernstigheid	ZNW:EKV:DE_
exporteerbaarheid	exporteerbaarheid	ZNW:EKV:DE_
faalveiligheid	faalveiligheid	ZNW:EKV:DE_
falsifieerbaarheid	falsifieerbaarheid	ZNW:EKV:DE_
familieloosheid	familieloosheid	ZNW:EKV:DE_
filtreerbaarheid	filtreerbaarheid	ZNW:EKV:DE_
foerageergelegenheid	foerageergelegenheid	ZNW:EKV:DE_
fractieaangelegenheid	fractieaangelegenheid	ZNW:EKV:DE_
fruitigheid	fruitigheid	ZNW:EKV:DE_
functieloosheid	functieloosheid	ZNW:EKV:DE_
geboeidheid	geboeidheid	ZNW:EKV:DE_
gebruikerszekerheid	gebruikerszekerheid	ZNW:EKV:DE_
geefbereidheid	geefbereidheid	ZNW:EKV:DE_
geest-persoonlijkheid	geest-persoonlijkheid	ZNW:EKV:DE_
geest-werkelijkheid	geest-werkelijkheid	ZNW:EKV:DE_
geestesbedrijvigheid	geestesbedrijvigheid	ZNW:EKV:DE_
geestesgezondheid	geestesgezondheid	ZNW:EKV:DE_
geesteswerkzaamheid	geesteswerkzaamheid	ZNW:EKV:DE_
geestloosheid	geestloosheid	ZNW:EKV:DE_
gefascineerdheid	gefascineerdheid	ZNW:EKV:DE_
gehaastheid	gehaastheid	ZNW:EKV:DE_
geheelheid	geheelheid	ZNW:EKV:DE_
geheid	geheid	ZNW:EKV:DE_
geheid	heien	ZNW:EKV:DE_
geiligheid	geiligheid	ZNW:EKV:DE_
gekleurdheid	gekleurdheid	ZNW:EKV:DE_
gelijkberechtigdheid	gelijkberechtigdheid	ZNW:EKV:DE_
geluidsloosheid	geluidsloosheid	ZNW:EKV:DE_
gemakzuchtigheid	gemakzuchtigheid	ZNW:EKV:DE_
gemeenschapsverantwoordelijkheid	gemeenschapsverantwoordelijkheid	ZNW:EKV:DE_
genadigheid	genadigheid	ZNW:EKV:DE_
geobsedeerdheid	geobsedeerdheid	ZNW:EKV:DE_
gerieflijkheid	gerieflijkheid	ZNW:EKV:DE_
geschiedenisloosheid	geschiedenisloosheid	ZNW:EKV:DE_
geserreerdheid	geserreerdheid	ZNW:EKV:DE_
geslachtsloosheid	geslachtsloosheid	ZNW:EKV:DE_
gestemdheid	gestemdheid	ZNW:EKV:DE_
getiktheid	getiktheid	ZNW:EKV:DE_
gevaarloosheid	gevaarloosheid	ZNW:EKV:DE_
gevoelsaangelegenheid	gevoelsaangelegenheid	ZNW:EKV:DE_
gevoelsloosheid	gevoelsloosheid	ZNW:EKV:DE_
gewaserosiegevoeligheid	gewaserosiegevoeligheid	ZNW:EKV:DE_
geweldigheid	geweldigheid	ZNW:EKV:DE_
geweldsbereidheid	geweldsbereidheid	ZNW:EKV:DE_
geweldsloosheid	geweldsloosheid	ZNW:EKV:DE_
gewestaangelegenheid	gewestaangelegenheid	ZNW:EKV:DE_
gewetensloosheid	gewetensloosheid	ZNW:EKV:DE_
gewetensvolheid	gewetensvolheid	ZNW:EKV:DE_
gezagsloosheid	gezagsloosheid	ZNW:EKV:DE_
gezichtsloosheid	gezichtsloosheid	ZNW:EKV:DE_
gezinsaangelegenheid	gezinsaangelegenheid	ZNW:EKV:DE_
geïnvolveerdheid	geïnvolveerdheid	ZNW:EKV:DE_
glasnijverheid	glasnijverheid	ZNW:EKV:DE_
godsdienstloosheid	godsdienstloosheid	ZNW:EKV:DE_
goedlachsheid	goedlachsheid	ZNW:EKV:DE_
grensloosheid	grensloosheid	ZNW:EKV:DE_
grieperigheid	grieperigheid	ZNW:EKV:DE_
groepsaangelegenheid	groepsaangelegenheid	ZNW:EKV:DE_
haarloosheid	haarloosheid	ZNW:EKV:DE_
hanigheid	hanigheid	ZNW:EKV:DE_
hengstigheid	hengstigheid	ZNW:EKV:DE_
herenaangelegenheid	herenaangelegenheid	ZNW:EKV:DE_
hersengesteldheid	hersengesteldheid	ZNW:EKV:DE_
hersengezondheid	hersengezondheid	ZNW:EKV:DE_
hersenloosheid	hersenloosheid	ZNW:EKV:DE_
hersenmoeheid	hersenmoeheid	ZNW:EKV:DE_
hersenwerkzaamheid	hersenwerkzaamheid	ZNW:EKV:DE_
hijgerigheid	hijgerigheid	ZNW:EKV:DE_
hinderlijkheid	hinderlijkheid	ZNW:EKV:DE_
hipheid	hipheid	ZNW:EKV:DE_
hoefbevangenheid	hoefbevangenheid	ZNW:EKV:DE_
hoefgezondheid	hoefgezondheid	ZNW:EKV:DE_
hoeknauwkeurigheid	hoeknauwkeurigheid	ZNW:EKV:DE_
hoofdelijkheid	hoofdelijkheid	ZNW:EKV:DE_
hoornloosheid	hoornloosheid	ZNW:EKV:DE_
horeca-aangelegenheid	horeca-aangelegenheid	ZNW:EKV:DE_
horkerigheid	horkerigheid	ZNW:EKV:DE_
huisveiligheid	huisveiligheid	ZNW:EKV:DE_
hulpbereidheid	hulpbereidheid	ZNW:EKV:DE_
hulploosheid	hulploosheid	ZNW:EKV:DE_
hyperwerkelijkheid	hyperwerkelijkheid	ZNW:EKV:DE_
identificeerbaarheid	identificeerbaarheid	ZNW:EKV:DE_
identiteitsloosheid	identiteitsloosheid	ZNW:EKV:DE_
ijshardheid	ijshardheid	ZNW:EKV:DE_
illegaalheid	illegaalheid	ZNW:EKV:DE_
incourantheid	incourantheid	ZNW:EKV:DE_
indexeerbaarheid	indexeerbaarheid	ZNW:EKV:DE_
ingeheid	inheien	ZNW:EKV:DE_
ingenieurswijsheid	ingenieurswijsheid	ZNW:EKV:DE_
ingrijpendheid	ingrijpendheid	ZNW:EKV:DE_
initiatiefloosheid	initiatiefloosheid	ZNW:EKV:DE_
instelbaarheid	instelbaarheid	ZNW:EKV:DE_
instinctloosheid	instinctloosheid	ZNW:EKV:DE_
instrumenteerbaarheid	instrumenteerbaarheid	ZNW:EKV:DE_
integerheid	integerheid	ZNW:EKV:DE_
integreerbaarheid	integreerbaarheid	ZNW:EKV:DE_
interessantheid	interessantheid	ZNW:EKV:DE_
interesseloosheid	interesseloosheid	ZNW:EKV:DE_
interferentiegevoeligheid	interferentiegevoeligheid	ZNW:EKV:DE_
interpreteerbaarheid	interpreteerbaarheid	ZNW:EKV:DE_
intronisatieplechtigheid	intronisatieplechtigheid	ZNW:EKV:DE_
jagerswijsheid	jagerswijsheid	ZNW:EKV:DE_
jazzgelegenheid	jazzgelegenheid	ZNW:EKV:DE_
jongensaangelegenheid	jongensaangelegenheid	ZNW:EKV:DE_
jongheid	jongheid	ZNW:EKV:DE_
kabinetsaangelegenheid	kabinetsaangelegenheid	ZNW:EKV:DE_
kantnijverheid	kantnijverheid	ZNW:EKV:DE_
kapitaaltoereikendheid	kapitaaltoereikendheid	ZNW:EKV:DE_
kennisloosheid	kennisloosheid	ZNW:EKV:DE_
ketenaangelegenheid	ketenaangelegenheid	ZNW:EKV:DE_
ketenklanttevredenheid	ketenklanttevredenheid	ZNW:EKV:DE_
keuzeloosheid	keuzeloosheid	ZNW:EKV:DE_
kitscherigheid	kitscherigheid	ZNW:EKV:DE_
klagerigheid	klagerigheid	ZNW:EKV:DE_
kleur-echtheid	kleur-echtheid	ZNW:EKV:DE_
knapperigheid	knapperigheid	ZNW:EKV:DE_
koersloosheid	koersloosheid	ZNW:EKV:DE_
koninkrijksaangelegenheid	koninkrijksaangelegenheid	ZNW:EKV:DE_
koopkrachtzekerheid	koopkrachtzekerheid	ZNW:EKV:DE_
kostendekkendheid	kostendekkendheid	ZNW:EKV:DE_
kringerigheid	kringerigheid	ZNW:EKV:DE_
krolsheid	krolsheid	ZNW:EKV:DE_
lactoseovergevoeligheid	lactoseovergevoeligheid	ZNW:EKV:DE_
laksigheid	laksigheid	ZNW:EKV:DE_
langetermijnverantwoordelijkheid	langetermijnverantwoordelijkheid	ZNW:EKV:DE_
lawaaierigheid	lawaaierigheid	ZNW:EKV:DE_
leergelegenheid	leergelegenheid	ZNW:EKV:DE_
letterlijkheid	letterlijkheid	ZNW:EKV:DE_
levenloosheid	levenloosheid	ZNW:EKV:DE_
leverbaarheid	leverbaarheid	ZNW:EKV:DE_
lichtgelijkmatigheid	lichtgelijkmatigheid	ZNW:EKV:DE_
lichtloosheid	lichtloosheid	ZNW:EKV:DE_
lijmhoeveelheid	lijmhoeveelheid	ZNW:EKV:DE_
maatgerichtheid	maatgerichtheid	ZNW:EKV:DE_
makkelijkheid	makkelijkheid	ZNW:EKV:DE_
mandeligheid	mandeligheid	ZNW:EKV:DE_
mannenaangelegenheid	mannenaangelegenheid	ZNW:EKV:DE_
manoeuvreerbaarheid	manoeuvreerbaarheid	ZNW:EKV:DE_
manoeuvreervaardigheid	manoeuvreervaardigheid	ZNW:EKV:DE_
marine-overheid	marine-overheid	ZNW:EKV:DE_
massa-aangelegenheid	massa-aangelegenheid	ZNW:EKV:DE_
massa-traagheid	massa-traagheid	ZNW:EKV:DE_
medewerkersveiligheid	medewerkersveiligheid	ZNW:EKV:DE_
media-aangelegenheid	media-aangelegenheid	ZNW:EKV:DE_
meeneembaarheid	meeneembaarheid	ZNW:EKV:DE_
meerheid	meerheid	ZNW:EKV:DE_
meetgrootheid	meetgrootheid	ZNW:EKV:DE_
melkbaarheid	melkbaarheid	ZNW:EKV:DE_
mengbaarheid	mengbaarheid	ZNW:EKV:DE_
mensenaangelegenheid	mensenaangelegenheid	ZNW:EKV:DE_
merkbaarheid	merkbaarheid	ZNW:EKV:DE_
merkgeilheid	merkgeilheid	ZNW:EKV:DE_
mini-minderheid	mini-minderheid	ZNW:EKV:DE_
moederloosheid	moederloosheid	ZNW:EKV:DE_
monsterlijkheid	monsterlijkheid	ZNW:EKV:DE_
moraalloosheid	moraalloosheid	ZNW:EKV:DE_
naamloosheid	naamloosheid	ZNW:EKV:DE_
naspeurbaarheid	naspeurbaarheid	ZNW:EKV:DE_
nastelbaarheid	nastelbaarheid	ZNW:EKV:DE_
niveaugelijkwaardigheid	niveaugelijkwaardigheid	ZNW:EKV:DE_
niveauloosheid	niveauloosheid	ZNW:EKV:DE_
objectloosheid	objectloosheid	ZNW:EKV:DE_
olieonafhankelijkheid	olieonafhankelijkheid	ZNW:EKV:DE_
onafheid	onafheid	ZNW:EKV:DE_
onbemiddeldheid	onbemiddeldheid	ZNW:EKV:DE_
onbespeelbaarheid	onbespeelbaarheid	ZNW:EKV:DE_
onbestemdheid	onbestemdheid	ZNW:EKV:DE_
ondernemendheid	ondernemendheid	ZNW:EKV:DE_
ongeconcentreerdheid	ongeconcentreerdheid	ZNW:EKV:DE_
ongecontroleerdheid	ongecontroleerdheid	ZNW:EKV:DE_
ongedeeldheid	ongedeeldheid	ZNW:EKV:DE_
ongelukkigheid	ongelukkigheid	ZNW:EKV:DE_
ongeremdheid	ongeremdheid	ZNW:EKV:DE_
ongeschondenheid	ongeschondenheid	ZNW:EKV:DE_
ongevalsbetrokkenheid	ongevalsbetrokkenheid	ZNW:EKV:DE_
onhuiselijkheid	onhuiselijkheid	ZNW:EKV:DE_
oninbaarheid	oninbaarheid	ZNW:EKV:DE_
online-aanwezigheid	online-aanwezigheid	ZNW:EKV:DE_
onmiddelijkheid	onmiddelijkheid	ZNW:EKV:DE_
onschuldigheid	onschuldigheid	ZNW:EKV:DE_
ontheemdheid	ontheemdheid	ZNW:EKV:DE_
ontworteldheid	ontworteldheid	ZNW:EKV:DE_
onverbeterlijkheid	onverbeterlijkheid	ZNW:EKV:DE_
onvervangbaarheid	onvervangbaarheid	ZNW:EKV:DE_
onverwijldheid	onverwijldheid	ZNW:EKV:DE_
onverwoestbaarheid	onverwoestbaarheid	ZNW:EKV:DE_
onverzoenbaarheid	onverzoenbaarheid	ZNW:EKV:DE_
onvolwaardigheid	onvolwaardigheid	ZNW:EKV:DE_
onvoorstelbaarheid	onvoorstelbaarheid	ZNW:EKV:DE_
onvoorzienbaarheid	onvoorzienbaarheid	ZNW:EKV:DE_
ooggevoeligheid	ooggevoeligheid	ZNW:EKV:DE_
oordeelloosheid	oordeelloosheid	ZNW:EKV:DE_
opmerkelijkheid	opmerkelijkheid	ZNW:EKV:DE_
opneembaarheid	opneembaarheid	ZNW:EKV:DE_
oppositieaangelegenheid	oppositieaangelegenheid	ZNW:EKV:DE_
opspoorbaarheid	opspoorbaarheid	ZNW:EKV:DE_
opvallendheid	opvallendheid	ZNW:EKV:DE_
ouderloosheid	ouderloosheid	ZNW:EKV:DE_
overdrachtelijkheid	overdrachtelijkheid	ZNW:EKV:DE_
paarbereidheid	paarbereidheid	ZNW:EKV:DE_
partijaangelegenheid	partijaangelegenheid	ZNW:EKV:DE_
passeerbaarheid	passeerbaarheid	ZNW:EKV:DE_
passendheid	passendheid	ZNW:EKV:DE_
patenteerbaarheid	patenteerbaarheid	ZNW:EKV:DE_
perspectiefloosheid	perspectiefloosheid	ZNW:EKV:DE_
pijnloosheid	pijnloosheid	ZNW:EKV:DE_
plaatsbaarheid	plaatsbaarheid	ZNW:EKV:DE_
plakkerigheid	plakkerigheid	ZNW:EKV:DE_
plasgelegenheid	plasgelegenheid	ZNW:EKV:DE_
plattelandsnijverheid	plattelandsnijverheid	ZNW:EKV:DE_
politieaangelegenheid	politieaangelegenheid	ZNW:EKV:DE_
polsloosheid	polsloosheid	ZNW:EKV:DE_
post-apartheid	post-apartheid	ZNW:EKV:DE_
prikkelloosheid	prikkelloosheid	ZNW:EKV:DE_
principeloosheid	principeloosheid	ZNW:EKV:DE_
probleemloosheid	probleemloosheid	ZNW:EKV:DE_
raakheid	raakheid	ZNW:EKV:DE_
radheid	radheid	ZNW:EKV:DE_
rafelingsgevoeligheid	rafelingsgevoeligheid	ZNW:EKV:DE_
rapheid	rapheid	ZNW:EKV:DE_
rapporteerbaarheid	rapporteerbaarheid	ZNW:EKV:DE_
rasgevoeligheid	rasgevoeligheid	ZNW:EKV:DE_
reactieloosheid	reactieloosheid	ZNW:EKV:DE_
realiseerbaarheid	realiseerbaarheid	ZNW:EKV:DE_
rechtgelijkheid	rechtgelijkheid	ZNW:EKV:DE_
rechtsstatelijkheid	rechtsstatelijkheid	ZNW:EKV:DE_
rechtstatelijkheid	rechtstatelijkheid	ZNW:EKV:DE_
regelbaarheid	regelbaarheid	ZNW:EKV:DE_
regeringsloosheid	regeringsloosheid	ZNW:EKV:DE_
reinigbaarheid	reinigbaarheid	ZNW:EKV:DE_
reisbereidheid	reisbereidheid	ZNW:EKV:DE_
reisvaardigheid	reisvaardigheid	ZNW:EKV:DE_
reizigerstevredenheid	reizigerstevredenheid	ZNW:EKV:DE_
reizigersveiligheid	reizigersveiligheid	ZNW:EKV:DE_
reizigerswijsheid	reizigerswijsheid	ZNW:EKV:DE_
religieloosheid	religieloosheid	ZNW:EKV:DE_
remediëringsdeskundigheid	remediëringsdeskundigheid	ZNW:EKV:DE_
renteloosheid	renteloosheid	ZNW:EKV:DE_
repeteernauwkeurigheid	repeteernauwkeurigheid	ZNW:EKV:DE_
respecteerbaarheid	respecteerbaarheid	ZNW:EKV:DE_
restbekwaamheid	restbekwaamheid	ZNW:EKV:DE_
restvochtigheid	restvochtigheid	ZNW:EKV:DE_
resultaatloosheid	resultaatloosheid	ZNW:EKV:DE_
richtingsloosheid	richtingsloosheid	ZNW:EKV:DE_
richtluchtvochtigheid	richtluchtvochtigheid	ZNW:EKV:DE_
rijksaangelegenheid	rijksaangelegenheid	ZNW:EKV:DE_
rillerigheid	rillerigheid	ZNW:EKV:DE_
rimpelloosheid	rimpelloosheid	ZNW:EKV:DE_
risicoloosheid	risicoloosheid	ZNW:EKV:DE_
rondborstigheid	rondborstigheid	ZNW:EKV:DE_
roofgierigheid	roofgierigheid	ZNW:EKV:DE_
rookgelegenheid	rookgelegenheid	ZNW:EKV:DE_
rotheid	rotheid	ZNW:EKV:DE_
routineaangelegenheid	routineaangelegenheid	ZNW:EKV:DE_
rundergezondheid	rundergezondheid	ZNW:EKV:DE_
schadeloosheid	schadeloosheid	ZNW:EKV:DE_
schofterigheid	schofterigheid	ZNW:EKV:DE_
schoolmeesterswijsheid	schoolmeesterswijsheid	ZNW:EKV:DE_
schriftelijkheid	schriftelijkheid	ZNW:EKV:DE_
schrijnendheid	schrijnendheid	ZNW:EKV:DE_
schuldigheid	schuldigheid	ZNW:EKV:DE_
sekse-apartheid	sekse-apartheid	ZNW:EKV:DE_
seksegelijkwaardigheid	seksegelijkwaardigheid	ZNW:EKV:DE_
slaaploosheid	slaaploosheid	ZNW:EKV:DE_
slibhoeveelheid	slibhoeveelheid	ZNW:EKV:DE_
smaakloosheid	smaakloosheid	ZNW:EKV:DE_
sneuheid	sneuheid	ZNW:EKV:DE_
snijrijpheid	snijrijpheid	ZNW:EKV:DE_
snotverkoudheid	snotverkoudheid	ZNW:EKV:DE_
solo-aangelegenheid	solo-aangelegenheid	ZNW:EKV:DE_
spanningsloosheid	spanningsloosheid	ZNW:EKV:DE_
speelbaarheid	speelbaarheid	ZNW:EKV:DE_
spoedeisendheid	spoedeisendheid	ZNW:EKV:DE_
spoorloosheid	spoorloosheid	ZNW:EKV:DE_
staartloosheid	staartloosheid	ZNW:EKV:DE_
staatsloosheid	staatsloosheid	ZNW:EKV:DE_
stadsaangelegenheid	stadsaangelegenheid	ZNW:EKV:DE_
status-geilheid	status-geilheid	ZNW:EKV:DE_
stekelachtigheid	stekelachtigheid	ZNW:EKV:DE_
stelvaardigheid	stelvaardigheid	ZNW:EKV:DE_
stemloosheid	stemloosheid	ZNW:EKV:DE_
stofhoeveelheid	stofhoeveelheid	ZNW:EKV:DE_
stolbaarheid	stolbaarheid	ZNW:EKV:DE_
stressloosheid	stressloosheid	ZNW:EKV:DE_
strijdloosheid	strijdloosheid	ZNW:EKV:DE_
strijdlustigheid	strijdlustigheid	ZNW:EKV:DE_
structuurloosheid	structuurloosheid	ZNW:EKV:DE_
studietaalvaardigheid	studietaalvaardigheid	ZNW:EKV:DE_
stuurbaarheid	stuurbaarheid	ZNW:EKV:DE_
systeemloosheid	systeemloosheid	ZNW:EKV:DE_
taalgelijkheid	taalgelijkheid	ZNW:EKV:DE_
taalgerichtheid	taalgerichtheid	ZNW:EKV:DE_
taalmeerderheid	taalmeerderheid	ZNW:EKV:DE_
taalzelfstandigheid	taalzelfstandigheid	ZNW:EKV:DE_
talentloosheid	talentloosheid	ZNW:EKV:DE_
tegeltjeswaarheid	tegeltjeswaarheid	ZNW:EKV:DE_
testbereidheid	testbereidheid	ZNW:EKV:DE_
testgelegenheid	testgelegenheid	ZNW:EKV:DE_
testgevoeligheid	testgevoeligheid	ZNW:EKV:DE_
testhoeveelheid	testhoeveelheid	ZNW:EKV:DE_
tijdingloosheid	tijdingloosheid	ZNW:EKV:DE_
tijdsloosheid	tijdsloosheid	ZNW:EKV:DE_
toekomstloosheid	toekomstloosheid	ZNW:EKV:DE_
toereikendheid	toereikendheid	ZNW:EKV:DE_
toetsbaarheid	toetsbaarheid	ZNW:EKV:DE_
toewijsbaarheid	toewijsbaarheid	ZNW:EKV:DE_
tolkvaardigheid	tolkvaardigheid	ZNW:EKV:DE_
toogwijsheid	toogwijsheid	ZNW:EKV:DE_
toondoofheid	toondoofheid	ZNW:EKV:DE_
transfereerbaarheid	transfereerbaarheid	ZNW:EKV:DE_
transporteerbaarheid	transporteerbaarheid	ZNW:EKV:DE_
trimvaardigheid	trimvaardigheid	ZNW:EKV:DE_
triomfantelijkheid	triomfantelijkheid	ZNW:EKV:DE_
twijfelloosheid	twijfelloosheid	ZNW:EKV:DE_
uitdrukkingsloosheid	uitdrukkingsloosheid	ZNW:EKV:DE_
uitwonendheid	uitwonendheid	ZNW:EKV:DE_
vaargelegenheid	vaargelegenheid	ZNW:EKV:DE_
veegvastheid	veegvastheid	ZNW:EKV:DE_
veelgezondheid	veelgezondheid	ZNW:EKV:DE_
veelkoppigheid	veelkoppigheid	ZNW:EKV:DE_
veelomvattendheid	veelomvattendheid	ZNW:EKV:DE_
veelstemmigheid	veelstemmigheid	ZNW:EKV:DE_
veelvoudigheid	veelvoudigheid	ZNW:EKV:DE_
veerveiligheid	veerveiligheid	ZNW:EKV:DE_
veiligheidsaangelegenheid	veiligheidsaangelegenheid	ZNW:EKV:DE_
veranderbaarheid	veranderbaarheid	ZNW:EKV:DE_
verantwoordingsloosheid	verantwoordingsloosheid	ZNW:EKV:DE_
verdedigingsloosheid	verdedigingsloosheid	ZNW:EKV:DE_
verdraagbaarheid	verdraagbaarheid	ZNW:EKV:DE_
verenigingsaangelegenheid	verenigingsaangelegenheid	ZNW:EKV:DE_
verfhoeveelheid	verfhoeveelheid	ZNW:EKV:DE_
vergeeflijkheid	vergeeflijkheid	ZNW:EKV:DE_
verhaalbaarheid	verhaalbaarheid	ZNW:EKV:DE_
vernietigbaarheid	vernietigbaarheid	ZNW:EKV:DE_
verschuldigdheid	verschuldigdheid	ZNW:EKV:DE_
vervangbaarheid	vervangbaarheid	ZNW:EKV:DE_
vervormbaarheid	vervormbaarheid	ZNW:EKV:DE_
verwisselbaarheid	verwisselbaarheid	ZNW:EKV:DE_
verzekeringsaangelegenheid	verzekeringsaangelegenheid	ZNW:EKV:DE_
verzetsloosheid	verzetsloosheid	ZNW:EKV:DE_
verzuildheid	verzuildheid	ZNW:EKV:DE_
visieloosheid	visieloosheid	ZNW:EKV:DE_
vleesloosheid	vleesloosheid	ZNW:EKV:DE_
vleugelloosheid	vleugelloosheid	ZNW:EKV:DE_
voeghardheid	voeghardheid	ZNW:EKV:DE_
voerhoeveelheid	voerhoeveelheid	ZNW:EKV:DE_
volkshuisvestingsverantwoordelijkheid	volkshuisvestingsverantwoordelijkheid	ZNW:EKV:DE_
voorleesbaarheid	voorleesbaarheid	ZNW:EKV:DE_
voorwaardelijkheid	voorwaardelijkheid	ZNW:EKV:DE_
voorzienbaarheid	voorzienbaarheid	ZNW:EKV:DE_
vormschoonheid	vormschoonheid	ZNW:EKV:DE_
vormselplechtigheid	vormselplechtigheid	ZNW:EKV:DE_
vormstijfheid	vormstijfheid	ZNW:EKV:DE_
vormzuiverheid	vormzuiverheid	ZNW:EKV:DE_
vredeloosheid	vredeloosheid	ZNW:EKV:DE_
vreesloosheid	vreesloosheid	ZNW:EKV:DE_
vreugdeloosheid	vreugdeloosheid	ZNW:EKV:DE_
vrouwenaangelegenheid	vrouwenaangelegenheid	ZNW:EKV:DE_
warmwaterhoeveelheid	warmwaterhoeveelheid	ZNW:EKV:DE_
waterspeelgelegenheid	waterspeelgelegenheid	ZNW:EKV:DE_
weeheid	weeheid	ZNW:EKV:DE_
weifelachtigheid	weifelachtigheid	ZNW:EKV:DE_
werkheiligheid	werkheiligheid	ZNW:EKV:DE_
werkhoeveelheid	werkhoeveelheid	ZNW:EKV:DE_
werknemersgezondheid	werknemersgezondheid	ZNW:EKV:DE_
werkveiligheid	werkveiligheid	ZNW:EKV:DE_
wetsongelijkheid	wetsongelijkheid	ZNW:EKV:DE_
wielergrootheid	wielergrootheid	ZNW:EKV:DE_
wielerwijsheid	wielerwijsheid	ZNW:EKV:DE_
wijkgerichtheid	wijkgerichtheid	ZNW:EKV:DE_
wilsbekwaamheid	wilsbekwaamheid	ZNW:EKV:DE_
winbaarheid	winbaarheid	ZNW:EKV:DE_
wisheid	wisheid	ZNW:EKV:DE_
woordloosheid	woordloosheid	ZNW:EKV:DE_
worteldoorgroeibestendigheid	worteldoorgroeibestendigheid	ZNW:EKV:DE_
zatheid	zatheid	ZNW:EKV:DE_
zeurderigheid	zeurderigheid	ZNW:EKV:DE_
zielloosheid	zielloosheid	ZNW:EKV:DE_
zintuiglijkheid	zintuiglijkheid	ZNW:EKV:DE_
zoekmachine-moeheid	zoekmachine-moeheid	ZNW:EKV:DE_
zoetelijkheid	zoetelijkheid	ZNW:EKV:DE_
zoetwaterhoeveelheid	zoetwaterhoeveelheid	ZNW:EKV:DE_
zompigheid	zompigheid	ZNW:EKV:DE_
zonnewerkzaamheid	zonnewerkzaamheid	ZNW:EKV:DE_
zuurstofloosheid	zuurstofloosheid	ZNW:EKV:DE_
zwaarteloosheid	zwaarteloosheid	ZNW:EKV:DE_
zwemveiligheid	zwemveiligheid	ZNW:EKV:DE_
acquisitievaardigheid	acquisitievaardigheid	ZNW:EKV:DE_
bewaarheid	bewaarheiden	ZNW:EKV:DE_
onderheid	onderheien	ZNW:EKV:DE_
vloeiendheid	vloeiendheid	ZNW:EKV:DE_
verlengbaarheid	verlengbaarheid	ZNW:EKV:DE_
staatloosheid	staatloosheid	ZNW:EKV:DE_
romigheid	romigheid	ZNW:EKV:DE_
andersheid	andersheid	ZNW:EKV:DE_
volhardendheid	volhardendheid	ZNW:EKV:DE_
getraindheid	getraindheid	ZNW:EKV:DE_
rebelsheid	rebelsheid	ZNW:EKV:DE_
lasbaarheid	lasbaarheid	ZNW:EKV:DE_
lolligheid	lolligheid	ZNW:EKV:DE_
rokerigheid	rokerigheid	ZNW:EKV:DE_
mankheid	mankheid	ZNW:EKV:DE_
zonnigheid	zonnigheid	ZNW:EKV:DE_
ruimheid	ruimheid	ZNW:EKV:DE_
gecijferdheid	gecijferdheid	ZNW:EKV:DE_
warrigheid	warrigheid	ZNW:EKV:DE_
heiigheid	heiigheid	ZNW:EKV:DE_
vlezigheid	vlezigheid	ZNW:EKV:DE_
warsheid	warsheid	ZNW:EKV:DE_
nepheid	nepheid	ZNW:EKV:DE_
mafheid	mafheid	ZNW:EKV:DE_
tofheid	tofheid	ZNW:EKV:DE_
foutheid	foutheid	ZNW:EKV:DE_
geelheid	geelheid	ZNW:EKV:DE_
heetheid	heetheid	ZNW:EKV:DE_
veeleisendheid	veeleisendheid	ZNW:EKV:DE_
haaksheid	haaksheid	ZNW:EKV:DE_
vroegheid	vroegheid	ZNW:EKV:DE_
procesverantwoordelijkheid	procesverantwoordelijkheid	ZNW:EKV:DE_
basisbenodigdheid	basisbenodigdheid	ZNW:EKV:DE_
buurtaangelegenheid	buurtaangelegenheid	ZNW:EKV:DE_
personeelsaangelegenheid	personeelsaangelegenheid	ZNW:EKV:DE_
wereldaangelegenheid	wereldaangelegenheid	ZNW:EKV:DE_
jazz-grootheid	jazz-grootheid	ZNW:EKV:DE_
jazzgrootheid	jazzgrootheid	ZNW:EKV:DE_
collega-overheid	collega-overheid	ZNW:EKV:DE_
mede-overheid	mede-overheid	ZNW:EKV:DE_
begaanheid	begaanheid	ZNW:EKV:DE_
onbekrompenheid	onbekrompenheid	ZNW:EKV:DE_
aanbevelenswaardigheid	aanbevelenswaardigheid	ZNW:EKV:DE_
aanhangigheid	aanhangigheid	ZNW:EKV:DE_
aansluitbaarheid	aansluitbaarheid	ZNW:EKV:DE_
aanspeelbaarheid	aanspeelbaarheid	ZNW:EKV:DE_
aanstellerigheid	aanstellerigheid	ZNW:EKV:DE_
aanstootgevendheid	aanstootgevendheid	ZNW:EKV:DE_
aanstuurbaarheid	aanstuurbaarheid	ZNW:EKV:DE_
aanwendbaarheid	aanwendbaarheid	ZNW:EKV:DE_
acuutheid	acuutheid	ZNW:EKV:DE_
adellijkheid	adellijkheid	ZNW:EKV:DE_
afgestomptheid	afgestomptheid	ZNW:EKV:DE_
afgezonderdheid	afgezonderdheid	ZNW:EKV:DE_
afkeurenswaardigheid	afkeurenswaardigheid	ZNW:EKV:DE_
afleverbaarheid	afleverbaarheid	ZNW:EKV:DE_
afrekenbaarheid	afrekenbaarheid	ZNW:EKV:DE_
afschrikwekkendheid	afschrikwekkendheid	ZNW:EKV:DE_
afspeelbaarheid	afspeelbaarheid	ZNW:EKV:DE_
afwasbaarheid	afwasbaarheid	ZNW:EKV:DE_
afwikkelbaarheid	afwikkelbaarheid	ZNW:EKV:DE_
afzonderlijkheid	afzonderlijkheid	ZNW:EKV:DE_
allesomvattendheid	allesomvattendheid	ZNW:EKV:DE_
almachtigheid	almachtigheid	ZNW:EKV:DE_
analyseerbaarheid	analyseerbaarheid	ZNW:EKV:DE_
angstaanjagendheid	angstaanjagendheid	ZNW:EKV:DE_
autoluwheid	autoluwheid	ZNW:EKV:DE_
baanbrekendheid	baanbrekendheid	ZNW:EKV:DE_
beboetbaarheid	beboetbaarheid	ZNW:EKV:DE_
beeldbepalendheid	beeldbepalendheid	ZNW:EKV:DE_
begerenswaardigheid	begerenswaardigheid	ZNW:EKV:DE_
begrijpbaarheid	begrijpbaarheid	ZNW:EKV:DE_
beheptheid	beheptheid	ZNW:EKV:DE_
bejaardheid	bejaardheid	ZNW:EKV:DE_
bekaktheid	bekaktheid	ZNW:EKV:DE_
belanghebbendheid	belanghebbendheid	ZNW:EKV:DE_
belangwekkendheid	belangwekkendheid	ZNW:EKV:DE_
benutbaarheid	benutbaarheid	ZNW:EKV:DE_
bepaalbaarheid	bepaalbaarheid	ZNW:EKV:DE_
beschermbaarheid	beschermbaarheid	ZNW:EKV:DE_
beschrijfbaarheid	beschrijfbaarheid	ZNW:EKV:DE_
beslisbaarheid	beslisbaarheid	ZNW:EKV:DE_
bespottelijkheid	bespottelijkheid	ZNW:EKV:DE_
bestuurlijkheid	bestuurlijkheid	ZNW:EKV:DE_
betreedbaarheid	betreedbaarheid	ZNW:EKV:DE_
bevisbaarheid	bevisbaarheid	ZNW:EKV:DE_
bevochtigbaarheid	bevochtigbaarheid	ZNW:EKV:DE_
bezwarendheid	bezwarendheid	ZNW:EKV:DE_
bijterigheid	bijterigheid	ZNW:EKV:DE_
bindendheid	bindendheid	ZNW:EKV:DE_
blikkerigheid	blikkerigheid	ZNW:EKV:DE_
bouwbaarheid	bouwbaarheid	ZNW:EKV:DE_
bovennatuurlijkheid	bovennatuurlijkheid	ZNW:EKV:DE_
bozigheid	bozigheid	ZNW:EKV:DE_
brandvertragendheid	brandvertragendheid	ZNW:EKV:DE_
breeddenkendheid	breeddenkendheid	ZNW:EKV:DE_
briljantheid	briljantheid	ZNW:EKV:DE_
bruinheid	bruinheid	ZNW:EKV:DE_
chagrijnigheid	chagrijnigheid	ZNW:EKV:DE_
communiceerbaarheid	communiceerbaarheid	ZNW:EKV:DE_
configureerbaarheid	configureerbaarheid	ZNW:EKV:DE_
daadkrachtigheid	daadkrachtigheid	ZNW:EKV:DE_
denkbaarheid	denkbaarheid	ZNW:EKV:DE_
dichtbevolktheid	dichtbevolktheid	ZNW:EKV:DE_
dichtbijheid	dichtbijheid	ZNW:EKV:DE_
diepgravendheid	diepgravendheid	ZNW:EKV:DE_
diffuusheid	diffuusheid	ZNW:EKV:DE_
doenbaarheid	doenbaarheid	ZNW:EKV:DE_
doezeligheid	doezeligheid	ZNW:EKV:DE_
doordringendheid	doordringendheid	ZNW:EKV:DE_
doordrinkbaarheid	doordrinkbaarheid	ZNW:EKV:DE_
doorkambaarheid	doorkambaarheid	ZNW:EKV:DE_
doorschijnendheid	doorschijnendheid	ZNW:EKV:DE_
doorvaarbaarheid	doorvaarbaarheid	ZNW:EKV:DE_
doorwaadbaarheid	doorwaadbaarheid	ZNW:EKV:DE_
doorwrochtheid	doorwrochtheid	ZNW:EKV:DE_
dorpsheid	dorpsheid	ZNW:EKV:DE_
draaibaarheid	draaibaarheid	ZNW:EKV:DE_
driestemmigheid	driestemmigheid	ZNW:EKV:DE_
drukheid	drukheid	ZNW:EKV:DE_
dubbelwandigheid	dubbelwandigheid	ZNW:EKV:DE_
dubbelzijdigheid	dubbelzijdigheid	ZNW:EKV:DE_
egaalheid	egaalheid	ZNW:EKV:DE_
eigenlijkheid	eigenlijkheid	ZNW:EKV:DE_
eigensoortigheid	eigensoortigheid	ZNW:EKV:DE_
eigenwilligheid	eigenwilligheid	ZNW:EKV:DE_
eisbaarheid	eisbaarheid	ZNW:EKV:DE_
ervaarbaarheid	ervaarbaarheid	ZNW:EKV:DE_
evalueerbaarheid	evalueerbaarheid	ZNW:EKV:DE_
evenwaardigheid	evenwaardigheid	ZNW:EKV:DE_
exciteerbaarheid	exciteerbaarheid	ZNW:EKV:DE_
explicietheid	explicietheid	ZNW:EKV:DE_
exploiteerbaarheid	exploiteerbaarheid	ZNW:EKV:DE_
extrapoleerbaarheid	extrapoleerbaarheid	ZNW:EKV:DE_
fairheid	fairheid	ZNW:EKV:DE_
falsificeerbaarheid	falsificeerbaarheid	ZNW:EKV:DE_
faseerbaarheid	faseerbaarheid	ZNW:EKV:DE_
fijnbesnaardheid	fijnbesnaardheid	ZNW:EKV:DE_
flexibelheid	flexibelheid	ZNW:EKV:DE_
fluweligheid	fluweligheid	ZNW:EKV:DE_
fotogeniekheid	fotogeniekheid	ZNW:EKV:DE_
fysiekheid	fysiekheid	ZNW:EKV:DE_
galantheid	galantheid	ZNW:EKV:DE_
gammelheid	gammelheid	ZNW:EKV:DE_
geaccidenteerdheid	geaccidenteerdheid	ZNW:EKV:DE_
geagiteerdheid	geagiteerdheid	ZNW:EKV:DE_
geconcentreerdheid	geconcentreerdheid	ZNW:EKV:DE_
gedeprimeerdheid	gedeprimeerdheid	ZNW:EKV:DE_
gedifferentieerdheid	gedifferentieerdheid	ZNW:EKV:DE_
gedisciplineerdheid	gedisciplineerdheid	ZNW:EKV:DE_
geforceerdheid	geforceerdheid	ZNW:EKV:DE_
gefrustreerdheid	gefrustreerdheid	ZNW:EKV:DE_
gehaaidheid	gehaaidheid	ZNW:EKV:DE_
gekendheid	gekendheid	ZNW:EKV:DE_
gelieerdheid	gelieerdheid	ZNW:EKV:DE_
geliefdheid	geliefdheid	ZNW:EKV:DE_
geluidswerendheid	geluidswerendheid	ZNW:EKV:DE_
gelukkigheid	gelukkigheid	ZNW:EKV:DE_
gemengdheid	gemengdheid	ZNW:EKV:DE_
gemiddeldheid	gemiddeldheid	ZNW:EKV:DE_
gemêleerdheid	gemêleerdheid	ZNW:EKV:DE_
gepreoccupeerdheid	gepreoccupeerdheid	ZNW:EKV:DE_
geschakeerdheid	geschakeerdheid	ZNW:EKV:DE_
geschiftheid	geschiftheid	ZNW:EKV:DE_
geslaagdheid	geslaagdheid	ZNW:EKV:DE_
gestrektheid	gestrektheid	ZNW:EKV:DE_
getraptheid	getraptheid	ZNW:EKV:DE_
gevorderdheid	gevorderdheid	ZNW:EKV:DE_
gietbaarheid	gietbaarheid	ZNW:EKV:DE_
godsvruchtigheid	godsvruchtigheid	ZNW:EKV:DE_
grassigheid	grassigheid	ZNW:EKV:DE_
grauwigheid	grauwigheid	ZNW:EKV:DE_
grijpbaarheid	grijpbaarheid	ZNW:EKV:DE_
grofkorreligheid	grofkorreligheid	ZNW:EKV:DE_
grofmazigheid	grofmazigheid	ZNW:EKV:DE_
gronderigheid	gronderigheid	ZNW:EKV:DE_
grootsprakerigheid	grootsprakerigheid	ZNW:EKV:DE_
haastigheid	haastigheid	ZNW:EKV:DE_
hardbaarheid	hardbaarheid	ZNW:EKV:DE_
hartstochtelijkheid	hartstochtelijkheid	ZNW:EKV:DE_
hedendaagsheid	hedendaagsheid	ZNW:EKV:DE_
heetgebakerdheid	heetgebakerdheid	ZNW:EKV:DE_
helderwetendheid	helderwetendheid	ZNW:EKV:DE_
herstelbaarheid	herstelbaarheid	ZNW:EKV:DE_
heuvelachtigheid	heuvelachtigheid	ZNW:EKV:DE_
hitgevoeligheid	hitgevoeligheid	ZNW:EKV:DE_
hondvriendelijkheid	hondvriendelijkheid	ZNW:EKV:DE_
hongerigheid	hongerigheid	ZNW:EKV:DE_
hoogdrempeligheid	hoogdrempeligheid	ZNW:EKV:DE_
hoogstaandheid	hoogstaandheid	ZNW:EKV:DE_
huilerigheid	huilerigheid	ZNW:EKV:DE_
ijverigheid	ijverigheid	ZNW:EKV:DE_
illusieloosheid	illusieloosheid	ZNW:EKV:DE_
immensheid	immensheid	ZNW:EKV:DE_
implementeerbaarheid	implementeerbaarheid	ZNW:EKV:DE_
inadequaatheid	inadequaatheid	ZNW:EKV:DE_
incompleetheid	incompleetheid	ZNW:EKV:DE_
inconsequentheid	inconsequentheid	ZNW:EKV:DE_
indrukbaarheid	indrukbaarheid	ZNW:EKV:DE_
inertheid	inertheid	ZNW:EKV:DE_
ingekeerdheid	ingekeerdheid	ZNW:EKV:DE_
ingenieusheid	ingenieusheid	ZNW:EKV:DE_
inroepbaarheid	inroepbaarheid	ZNW:EKV:DE_
introvertheid	introvertheid	ZNW:EKV:DE_
invloedrijkheid	invloedrijkheid	ZNW:EKV:DE_
invoelbaarheid	invoelbaarheid	ZNW:EKV:DE_
invulbaarheid	invulbaarheid	ZNW:EKV:DE_
inwendigheid	inwendigheid	ZNW:EKV:DE_
joodsheid	joodsheid	ZNW:EKV:DE_
kalmheid	kalmheid	ZNW:EKV:DE_
kankerverwekkendheid	kankerverwekkendheid	ZNW:EKV:DE_
kapitaalkrachtigheid	kapitaalkrachtigheid	ZNW:EKV:DE_
kenmerkendheid	kenmerkendheid	ZNW:EKV:DE_
kerksheid	kerksheid	ZNW:EKV:DE_
kinderrijkheid	kinderrijkheid	ZNW:EKV:DE_
klammigheid	klammigheid	ZNW:EKV:DE_
kloterigheid	kloterigheid	ZNW:EKV:DE_
knuffelbaarheid	knuffelbaarheid	ZNW:EKV:DE_
koninklijkheid	koninklijkheid	ZNW:EKV:DE_
koortsachtigheid	koortsachtigheid	ZNW:EKV:DE_
kopieerbaarheid	kopieerbaarheid	ZNW:EKV:DE_
koppelbaarheid	koppelbaarheid	ZNW:EKV:DE_
kortbenigheid	kortbenigheid	ZNW:EKV:DE_
koudbloedigheid	koudbloedigheid	ZNW:EKV:DE_
krachtigheid	krachtigheid	ZNW:EKV:DE_
krakkemikkigheid	krakkemikkigheid	ZNW:EKV:DE_
kwaadwillendheid	kwaadwillendheid	ZNW:EKV:DE_
kwantificeerbaarheid	kwantificeerbaarheid	ZNW:EKV:DE_
labbekakkerigheid	labbekakkerigheid	ZNW:EKV:DE_
landschappelijkheid	landschappelijkheid	ZNW:EKV:DE_
langgerektheid	langgerektheid	ZNW:EKV:DE_
langlevendheid	langlevendheid	ZNW:EKV:DE_
lekkerheid	lekkerheid	ZNW:EKV:DE_
leutigheid	leutigheid	ZNW:EKV:DE_
levensbeschouwelijkheid	levensbeschouwelijkheid	ZNW:EKV:DE_
levenslustigheid	levenslustigheid	ZNW:EKV:DE_
losbolligheid	losbolligheid	ZNW:EKV:DE_
machtigheid	machtigheid	ZNW:EKV:DE_
machtsbelustheid	machtsbelustheid	ZNW:EKV:DE_
majesteitelijkheid	majesteitelijkheid	ZNW:EKV:DE_
mallotigheid	mallotigheid	ZNW:EKV:DE_
marsvaardigheid	marsvaardigheid	ZNW:EKV:DE_
meercelligheid	meercelligheid	ZNW:EKV:DE_
meerlagigheid	meerlagigheid	ZNW:EKV:DE_
meezingbaarheid	meezingbaarheid	ZNW:EKV:DE_
meisjesachtigheid	meisjesachtigheid	ZNW:EKV:DE_
mensonwaardigheid	mensonwaardigheid	ZNW:EKV:DE_
misbaarheid	misbaarheid	ZNW:EKV:DE_
misplaatstheid	misplaatstheid	ZNW:EKV:DE_
moutigheid	moutigheid	ZNW:EKV:DE_
naleefbaarheid	naleefbaarheid	ZNW:EKV:DE_
navigeerbaarheid	navigeerbaarheid	ZNW:EKV:DE_
navolgbaarheid	navolgbaarheid	ZNW:EKV:DE_
nichterigheid	nichterigheid	ZNW:EKV:DE_
nietsontziendheid	nietsontziendheid	ZNW:EKV:DE_
normaalheid	normaalheid	ZNW:EKV:DE_
notigheid	notigheid	ZNW:EKV:DE_
objectiveerbaarheid	objectiveerbaarheid	ZNW:EKV:DE_
oerdegelijkheid	oerdegelijkheid	ZNW:EKV:DE_
ogenblikkelijkheid	ogenblikkelijkheid	ZNW:EKV:DE_
omstredenheid	omstredenheid	ZNW:EKV:DE_
omwisselbaarheid	omwisselbaarheid	ZNW:EKV:DE_
onaangedaanheid	onaangedaanheid	ZNW:EKV:DE_
onafdwingbaarheid	onafdwingbaarheid	ZNW:EKV:DE_
onalledaagsheid	onalledaagsheid	ZNW:EKV:DE_
onbegaanbaarheid	onbegaanbaarheid	ZNW:EKV:DE_
onbegrepenheid	onbegrepenheid	ZNW:EKV:DE_
onbeheerstheid	onbeheerstheid	ZNW:EKV:DE_
onbepaalbaarheid	onbepaalbaarheid	ZNW:EKV:DE_
onbereidheid	onbereidheid	ZNW:EKV:DE_
onbereidwilligheid	onbereidwilligheid	ZNW:EKV:DE_
onbesnedenheid	onbesnedenheid	ZNW:EKV:DE_
onbevooroordeeldheid	onbevooroordeeldheid	ZNW:EKV:DE_
onbewijsbaarheid	onbewijsbaarheid	ZNW:EKV:DE_
onbewoonbaarheid	onbewoonbaarheid	ZNW:EKV:DE_
ondefinieerbaarheid	ondefinieerbaarheid	ZNW:EKV:DE_
ondenkbaarheid	ondenkbaarheid	ZNW:EKV:DE_
onderkoeldheid	onderkoeldheid	ZNW:EKV:DE_
onderontwikkeldheid	onderontwikkeldheid	ZNW:EKV:DE_
onderscheidbaarheid	onderscheidbaarheid	ZNW:EKV:DE_
onderzoekbaarheid	onderzoekbaarheid	ZNW:EKV:DE_
ondoeltreffendheid	ondoeltreffendheid	ZNW:EKV:DE_
ondoorlaatbaarheid	ondoorlaatbaarheid	ZNW:EKV:DE_
ondoorlatendheid	ondoorlatendheid	ZNW:EKV:DE_
ondoorschijnendheid	ondoorschijnendheid	ZNW:EKV:DE_
oneigenlijkheid	oneigenlijkheid	ZNW:EKV:DE_
ongeborgenheid	ongeborgenheid	ZNW:EKV:DE_
ongebreideldheid	ongebreideldheid	ZNW:EKV:DE_
ongebruikelijkheid	ongebruikelijkheid	ZNW:EKV:DE_
ongedisciplineerdheid	ongedisciplineerdheid	ZNW:EKV:DE_
ongehechtheid	ongehechtheid	ZNW:EKV:DE_
ongelijkvormigheid	ongelijkvormigheid	ZNW:EKV:DE_
ongeoorloofdheid	ongeoorloofdheid	ZNW:EKV:DE_
ongeordendheid	ongeordendheid	ZNW:EKV:DE_
ongeorganiseerdheid	ongeorganiseerdheid	ZNW:EKV:DE_
ongepolijstheid	ongepolijstheid	ZNW:EKV:DE_
ongerichtheid	ongerichtheid	ZNW:EKV:DE_
ongestoordheid	ongestoordheid	ZNW:EKV:DE_
ongetraindheid	ongetraindheid	ZNW:EKV:DE_
ongevormdheid	ongevormdheid	ZNW:EKV:DE_
ongrondwettelijkheid	ongrondwettelijkheid	ZNW:EKV:DE_
onheilspellendheid	onheilspellendheid	ZNW:EKV:DE_
onherhaalbaarheid	onherhaalbaarheid	ZNW:EKV:DE_
onherkenbaarheid	onherkenbaarheid	ZNW:EKV:DE_
onherleidbaarheid	onherleidbaarheid	ZNW:EKV:DE_
onherstelbaarheid	onherstelbaarheid	ZNW:EKV:DE_
onhoffelijkheid	onhoffelijkheid	ZNW:EKV:DE_
onkundigheid	onkundigheid	ZNW:EKV:DE_
onlosmakelijkheid	onlosmakelijkheid	ZNW:EKV:DE_
onmaakbaarheid	onmaakbaarheid	ZNW:EKV:DE_
onnadrukkelijkheid	onnadrukkelijkheid	ZNW:EKV:DE_
onnavolgbaarheid	onnavolgbaarheid	ZNW:EKV:DE_
onomkoopbaarheid	onomkoopbaarheid	ZNW:EKV:DE_
onontbindbaarheid	onontbindbaarheid	ZNW:EKV:DE_
onopgesmuktheid	onopgesmuktheid	ZNW:EKV:DE_
onopmerkzaamheid	onopmerkzaamheid	ZNW:EKV:DE_
onoverbrugbaarheid	onoverbrugbaarheid	ZNW:EKV:DE_
onpeilbaarheid	onpeilbaarheid	ZNW:EKV:DE_
onsterflijkheid	onsterflijkheid	ZNW:EKV:DE_
onterechtheid	onterechtheid	ZNW:EKV:DE_
onuitroeibaarheid	onuitroeibaarheid	ZNW:EKV:DE_
onveranderbaarheid	onveranderbaarheid	ZNW:EKV:DE_
onverbindendheid	onverbindendheid	ZNW:EKV:DE_
onverhaalbaarheid	onverhaalbaarheid	ZNW:EKV:DE_
onverkoopbaarheid	onverkoopbaarheid	ZNW:EKV:DE_
onvermijdbaarheid	onvermijdbaarheid	ZNW:EKV:DE_
onvermogendheid	onvermogendheid	ZNW:EKV:DE_
onverschuldigdheid	onverschuldigdheid	ZNW:EKV:DE_
onvervulbaarheid	onvervulbaarheid	ZNW:EKV:DE_
onverzadigdheid	onverzadigdheid	ZNW:EKV:DE_
onverzorgdheid	onverzorgdheid	ZNW:EKV:DE_
onvlakheid	onvlakheid	ZNW:EKV:DE_
onvolgroeidheid	onvolgroeidheid	ZNW:EKV:DE_
onwezenlijkheid	onwezenlijkheid	ZNW:EKV:DE_
onzakelijkheid	onzakelijkheid	ZNW:EKV:DE_
onzaligheid	onzaligheid	ZNW:EKV:DE_
onzegbaarheid	onzegbaarheid	ZNW:EKV:DE_
oogstbaarheid	oogstbaarheid	ZNW:EKV:DE_
oorlogszuchtigheid	oorlogszuchtigheid	ZNW:EKV:DE_
openlijkheid	openlijkheid	ZNW:EKV:DE_
oproepbaarheid	oproepbaarheid	ZNW:EKV:DE_
opschaalbaarheid	opschaalbaarheid	ZNW:EKV:DE_
opvoedbaarheid	opvoedbaarheid	ZNW:EKV:DE_
opvouwbaarheid	opvouwbaarheid	ZNW:EKV:DE_
opzegbaarheid	opzegbaarheid	ZNW:EKV:DE_
overcompleetheid	overcompleetheid	ZNW:EKV:DE_
overijverigheid	overijverigheid	ZNW:EKV:DE_
overschilderbaarheid	overschilderbaarheid	ZNW:EKV:DE_
overspeligheid	overspeligheid	ZNW:EKV:DE_
paniekerigheid	paniekerigheid	ZNW:EKV:DE_
paradijselijkheid	paradijselijkheid	ZNW:EKV:DE_
patserigheid	patserigheid	ZNW:EKV:DE_
perfectheid	perfectheid	ZNW:EKV:DE_
pietepeuterigheid	pietepeuterigheid	ZNW:EKV:DE_
pikantheid	pikantheid	ZNW:EKV:DE_
pissigheid	pissigheid	ZNW:EKV:DE_
planbaarheid	planbaarheid	ZNW:EKV:DE_
pluizigheid	pluizigheid	ZNW:EKV:DE_
poenerigheid	poenerigheid	ZNW:EKV:DE_
pompeusheid	pompeusheid	ZNW:EKV:DE_
popperigheid	popperigheid	ZNW:EKV:DE_
prachtigheid	prachtigheid	ZNW:EKV:DE_
profijtelijkheid	profijtelijkheid	ZNW:EKV:DE_
raadpleegbaarheid	raadpleegbaarheid	ZNW:EKV:DE_
raakbaarheid	raakbaarheid	ZNW:EKV:DE_
recentheid	recentheid	ZNW:EKV:DE_
rechtgeaardheid	rechtgeaardheid	ZNW:EKV:DE_
rechthoekigheid	rechthoekigheid	ZNW:EKV:DE_
rechtsheid	rechtsheid	ZNW:EKV:DE_
rechtstreeksheid	rechtstreeksheid	ZNW:EKV:DE_
reconstrueerbaarheid	reconstrueerbaarheid	ZNW:EKV:DE_
reduceerbaarheid	reduceerbaarheid	ZNW:EKV:DE_
repeteerbaarheid	repeteerbaarheid	ZNW:EKV:DE_
repliceerbaarheid	repliceerbaarheid	ZNW:EKV:DE_
reusachtigheid	reusachtigheid	ZNW:EKV:DE_
risicodragendheid	risicodragendheid	ZNW:EKV:DE_
rozigheid	rozigheid	ZNW:EKV:DE_
rustgevendheid	rustgevendheid	ZNW:EKV:DE_
scanbaarheid	scanbaarheid	ZNW:EKV:DE_
schandaligheid	schandaligheid	ZNW:EKV:DE_
scheidbaarheid	scheidbaarheid	ZNW:EKV:DE_
schijterigheid	schijterigheid	ZNW:EKV:DE_
schilferigheid	schilferigheid	ZNW:EKV:DE_
schokkerigheid	schokkerigheid	ZNW:EKV:DE_
schrikkerigheid	schrikkerigheid	ZNW:EKV:DE_
schuinheid	schuinheid	ZNW:EKV:DE_
secuurheid	secuurheid	ZNW:EKV:DE_
sensatiebelustheid	sensatiebelustheid	ZNW:EKV:DE_
snijdbaarheid	snijdbaarheid	ZNW:EKV:DE_
snotterigheid	snotterigheid	ZNW:EKV:DE_
soldeerbaarheid	soldeerbaarheid	ZNW:EKV:DE_
speciaalheid	speciaalheid	ZNW:EKV:DE_
specifiekheid	specifiekheid	ZNW:EKV:DE_
splijtbaarheid	splijtbaarheid	ZNW:EKV:DE_
spraakmakendheid	spraakmakendheid	ZNW:EKV:DE_
springerigheid	springerigheid	ZNW:EKV:DE_
sprookjesachtigheid	sprookjesachtigheid	ZNW:EKV:DE_
steekhoudendheid	steekhoudendheid	ZNW:EKV:DE_
stiekemheid	stiekemheid	ZNW:EKV:DE_
stonedheid	stonedheid	ZNW:EKV:DE_
stormachtigheid	stormachtigheid	ZNW:EKV:DE_
stralendheid	stralendheid	ZNW:EKV:DE_
streberigheid	streberigheid	ZNW:EKV:DE_
streekeigenheid	streekeigenheid	ZNW:EKV:DE_
streperigheid	streperigheid	ZNW:EKV:DE_
strooibaarheid	strooibaarheid	ZNW:EKV:DE_
subsidieerbaarheid	subsidieerbaarheid	ZNW:EKV:DE_
teerhoudendheid	teerhoudendheid	ZNW:EKV:DE_
tegensprekelijkheid	tegensprekelijkheid	ZNW:EKV:DE_
terugneembaarheid	terugneembaarheid	ZNW:EKV:DE_
tijdrovendheid	tijdrovendheid	ZNW:EKV:DE_
toegewijdheid	toegewijdheid	ZNW:EKV:DE_
toekomstigheid	toekomstigheid	ZNW:EKV:DE_
toonbaarheid	toonbaarheid	ZNW:EKV:DE_
totaalheid	totaalheid	ZNW:EKV:DE_
transparantheid	transparantheid	ZNW:EKV:DE_
trekkerigheid	trekkerigheid	ZNW:EKV:DE_
tweebenigheid	tweebenigheid	ZNW:EKV:DE_
tweekleurigheid	tweekleurigheid	ZNW:EKV:DE_
tweesporigheid	tweesporigheid	ZNW:EKV:DE_
tweevoudigheid	tweevoudigheid	ZNW:EKV:DE_
uitgeputheid	uitgeputheid	ZNW:EKV:DE_
uitlegbaarheid	uitlegbaarheid	ZNW:EKV:DE_
uitleggerigheid	uitleggerigheid	ZNW:EKV:DE_
uitloogbaarheid	uitloogbaarheid	ZNW:EKV:DE_
uitputbaarheid	uitputbaarheid	ZNW:EKV:DE_
uitspreekbaarheid	uitspreekbaarheid	ZNW:EKV:DE_
vaderlandslievendheid	vaderlandslievendheid	ZNW:EKV:DE_
vakinhoudelijkheid	vakinhoudelijkheid	ZNW:EKV:DE_
vangbaarheid	vangbaarheid	ZNW:EKV:DE_
veelkantigheid	veelkantigheid	ZNW:EKV:DE_
verbeterbaarheid	verbeterbaarheid	ZNW:EKV:DE_
vergetelijkheid	vergetelijkheid	ZNW:EKV:DE_
vergunbaarheid	vergunbaarheid	ZNW:EKV:DE_
verliesgevendheid	verliesgevendheid	ZNW:EKV:DE_
verpompbaarheid	verpompbaarheid	ZNW:EKV:DE_
verrekenbaarheid	verrekenbaarheid	ZNW:EKV:DE_
verschuifbaarheid	verschuifbaarheid	ZNW:EKV:DE_
verspaanbaarheid	verspaanbaarheid	ZNW:EKV:DE_
verstoktheid	verstoktheid	ZNW:EKV:DE_
vervelendheid	vervelendheid	ZNW:EKV:DE_
vervoerbaarheid	vervoerbaarheid	ZNW:EKV:DE_
verwijderbaarheid	verwijderbaarheid	ZNW:EKV:DE_
verzoenbaarheid	verzoenbaarheid	ZNW:EKV:DE_
viersporigheid	viersporigheid	ZNW:EKV:DE_
vierstemmigheid	vierstemmigheid	ZNW:EKV:DE_
vochtwerendheid	vochtwerendheid	ZNW:EKV:DE_
voelbaarheid	voelbaarheid	ZNW:EKV:DE_
volgroeidheid	volgroeidheid	ZNW:EKV:DE_
volhoudbaarheid	volhoudbaarheid	ZNW:EKV:DE_
voltalligheid	voltalligheid	ZNW:EKV:DE_
voorlijkheid	voorlijkheid	ZNW:EKV:DE_
vraaggestuurdheid	vraaggestuurdheid	ZNW:EKV:DE_
vrijheidslievendheid	vrijheidslievendheid	ZNW:EKV:DE_
wanhopigheid	wanhopigheid	ZNW:EKV:DE_
waterafstotendheid	waterafstotendheid	ZNW:EKV:DE_
waterkerendheid	waterkerendheid	ZNW:EKV:DE_
weergevoeligheid	weergevoeligheid	ZNW:EKV:DE_
weerlegbaarheid	weerlegbaarheid	ZNW:EKV:DE_
weidelijkheid	weidelijkheid	ZNW:EKV:DE_
welgevormdheid	welgevormdheid	ZNW:EKV:DE_
welriekendheid	welriekendheid	ZNW:EKV:DE_
wereldlijkheid	wereldlijkheid	ZNW:EKV:DE_
wereldvermaardheid	wereldvermaardheid	ZNW:EKV:DE_
wijsneuzigheid	wijsneuzigheid	ZNW:EKV:DE_
woordeloosheid	woordeloosheid	ZNW:EKV:DE_
woordspeligheid	woordspeligheid	ZNW:EKV:DE_
wormstekigheid	wormstekigheid	ZNW:EKV:DE_
wraakzuchtigheid	wraakzuchtigheid	ZNW:EKV:DE_
zanderigheid	zanderigheid	ZNW:EKV:DE_
zeikerigheid	zeikerigheid	ZNW:EKV:DE_
zelfsturendheid	zelfsturendheid	ZNW:EKV:DE_
zelfvoorzienendheid	zelfvoorzienendheid	ZNW:EKV:DE_
zingbaarheid	zingbaarheid	ZNW:EKV:DE_
zorgbehoevendheid	zorgbehoevendheid	ZNW:EKV:DE_
zoutigheid	zoutigheid	ZNW:EKV:DE_
zwaarwegendheid	zwaarwegendheid	ZNW:EKV:DE_
zweterigheid	zweterigheid	ZNW:EKV:DE_
terneergeslagenheid	terneergeslagenheid	ZNW:EKV:DE_
uitdagendheid	uitdagendheid	ZNW:EKV:DE_
zintuigelijkheid	zintuigelijkheid	ZNW:EKV:DE_
hoppigheid	hoppigheid	ZNW:EKV:DE_
vlagerigheid	vlagerigheid	ZNW:EKV:DE_
mineraligheid	mineraligheid	ZNW:EKV:DE_
uitgesprokenheid	uitgesprokenheid	ZNW:EKV:DE_
waterwerendheid	waterwerendheid	ZNW:EKV:DE_
watervoerendheid	watervoerendheid	ZNW:EKV:DE_
hyperigheid	hyperigheid	ZNW:EKV:DE_
tweepoligheid	tweepoligheid	ZNW:EKV:DE_
tranerigheid	tranerigheid	ZNW:EKV:DE_
niksigheid	niksigheid	ZNW:EKV:DE_
zelfgerichtheid	zelfgerichtheid	ZNW:EKV:DE_
dubbelkorigheid	dubbelkorigheid	ZNW:EKV:DE_
nikserigheid	nikserigheid	ZNW:EKV:DE_
hippigheid	hippigheid	ZNW:EKV:DE_
meerstammigheid	meerstammigheid	ZNW:EKV:DE_
blijvendheid	blijvendheid	ZNW:EKV:DE_
dwingendheid	dwingendheid	ZNW:EKV:DE_
overtuigdheid	overtuigdheid	ZNW:EKV:DE_
sprekendheid	sprekendheid	ZNW:EKV:DE_
afwijkendheid	afwijkendheid	ZNW:EKV:DE_
berekendheid	berekendheid	ZNW:EKV:DE_
berekenendheid	berekenendheid	ZNW:EKV:DE_
samenhangendheid	samenhangendheid	ZNW:EKV:DE_
afgrondelijkheid	afgrondelijkheid	ZNW:EKV:DE_
fietsbaarheid	fietsbaarheid	ZNW:EKV:DE_
werkonwilligheid	werkonwilligheid	ZNW:EKV:DE_
nadenkendheid	nadenkendheid	ZNW:EKV:DE_
dronkenheid	dronkenheid	ZNW:EKV:DE_
hitserigheid	hitserigheid	ZNW:EKV:DE_
koehakkigheid	koehakkigheid	ZNW:EKV:DE_
veellagigheid	veellagigheid	ZNW:EKV:DE_
valsigheid	valsigheid	ZNW:EKV:DE_
nageeflijkheid	nageeflijkheid	ZNW:EKV:DE_
rookwerendheid	rookwerendheid	ZNW:EKV:DE_
onbeslisbaarheid	onbeslisbaarheid	ZNW:EKV:DE_
doorwortelbaarheid	doorwortelbaarheid	ZNW:EKV:DE_
sociaalvoelendheid	sociaalvoelendheid	ZNW:EKV:DE_
geestesgestoordheid	geestesgestoordheid	ZNW:EKV:DE_
onverborgenheid	onverborgenheid	ZNW:EKV:DE_
ICT-geletterdheid	ICT-geletterdheid	ZNW:EKV:DE_
ademvrijheid	ademvrijheid	ZNW:EKV:DE_
allergievriendelijkheid	allergievriendelijkheid	ZNW:EKV:DE_
angstloosheid	angstloosheid	ZNW:EKV:DE_
arbeidsmarktgerichtheid	arbeidsmarktgerichtheid	ZNW:EKV:DE_
baasgerichtheid	baasgerichtheid	ZNW:EKV:DE_
leesrijpheid	leesrijpheid	ZNW:EKV:DE_
bedrijfsvriendelijkheid	bedrijfsvriendelijkheid	ZNW:EKV:DE_
regiogerichtheid	regiogerichtheid	ZNW:EKV:DE_
snijbestendigheid	snijbestendigheid	ZNW:EKV:DE_
bestemmingsvrijheid	bestemmingsvrijheid	ZNW:EKV:DE_
bezoekersvriendelijkheid	bezoekersvriendelijkheid	ZNW:EKV:DE_
regelgebondenheid	regelgebondenheid	ZNW:EKV:DE_
dierwaardigheid	dierwaardigheid	ZNW:EKV:DE_
leergerichtheid	leergerichtheid	ZNW:EKV:DE_
merkgevoeligheid	merkgevoeligheid	ZNW:EKV:DE_
merkgebondenheid	merkgebondenheid	ZNW:EKV:DE_
luchthavengebondenheid	luchthavengebondenheid	ZNW:EKV:DE_
plotloosheid	plotloosheid	ZNW:EKV:DE_
storinggevoeligheid	storinggevoeligheid	ZNW:EKV:DE_
detailrijkheid	detailrijkheid	ZNW:EKV:DE_
vaatwasmachinebestendigheid	vaatwasmachinebestendigheid	ZNW:EKV:DE_
behandelvrijheid	behandelvrijheid	ZNW:EKV:DE_
privacyvriendelijkheid	privacyvriendelijkheid	ZNW:EKV:DE_
wasmachinebestendigheid	wasmachinebestendigheid	ZNW:EKV:DE_
hobbymatigheid	hobbymatigheid	ZNW:EKV:DE_
stijlgetrouwheid	stijlgetrouwheid	ZNW:EKV:DE_
roemloosheid	roemloosheid	ZNW:EKV:DE_
chloorbestendigheid	chloorbestendigheid	ZNW:EKV:DE_
rookvrijheid	rookvrijheid	ZNW:EKV:DE_
contacteerbaarheid	contacteerbaarheid	ZNW:EKV:DE_
kernvrijheid	kernvrijheid	ZNW:EKV:DE_
klankgerichtheid	klankgerichtheid	ZNW:EKV:DE_
koreaan	koreaan	ZNW:EKV:DE_
datavrijheid	datavrijheid	ZNW:EKV:DE_
streekeigenheden	streekeigenheid	ZNW:MRV:DE_
bachelordiploma	bachelordiploma	FLG:TSS:MOR
bachelorsdiploma	bachelordiploma	FLG:TSS:LSS
