# deleted postag entries
#-------------------------------------------------------------------------------
# Do not add words here, but report them to languagetool@taaltik.nl
#-------------------------------------------------------------------------------
aandeelhoudersbetrokkenheid	aandeelhoudersbetrokkenheid	ZNW:EKV
aangeschotenheid	aangeschotenheid	ZNW:EKV
aanpasbaarheid	aanpasbaarheid	ZNW:EKV
aanraakbaarheid	aanraakbaarheid	ZNW:EKV
aansprekendheid	aansprekendheid	ZNW:EKV
aanvullendheid	aanvullendheid	ZNW:EKV
abruptheid	abruptheid	ZNW:EKV
abstractheid	abstractheid	ZNW:EKV
absurdheid	absurdheid	ZNW:EKV
accuraatheid	accuraatheid	ZNW:EKV
achterstalligheid	achterstalligheid	ZNW:EKV
ademloosheid	ademloosheid	ZNW:EKV
adequaatheid	adequaatheid	ZNW:EKV
afgrijslijkheid	afgrijslijkheid	UNSPECIFIED
afhoudendheid	afhoudendheid	ZNW:EKV
afleesbaarheid	afleesbaarheid	ZNW:EKV
afleidbaarheid	afleidbaarheid	ZNW:EKV
afsluitbaarheid	afsluitbaarheid	ZNW:EKV
afstotelijkheid	afstotelijkheid	ZNW:EKV
afstudeerplechtigheid	afstudeerplechtigheid	ZNW:EKV
aftapbaarheid	aftapbaarheid	ZNW:EKV
aftelbaarheid	aftelbaarheid	ZNW:EKV
afwachtendheid	afwachtendheid	ZNW:EKV
ambtelijkheid	ambtelijkheid	ZNW:EKV
anti-verkoudheid	anti-verkoudheid	ZNW:EKV
anti-vermoeidheid	anti-vermoeidheid	ZNW:EKV
anti-waarheid	anti-waarheid	ZNW:EKV
arbeidsloosheid	arbeidsloosheid	ZNW:EKV
attentheid	attentheid	ZNW:EKV
authentiekheid	authentiekheid	ZNW:EKV
baanonzekerheid	baanonzekerheid	ZNW:EKV
baardloosheid	baardloosheid	ZNW:EKV
barheid	barheid	ZNW:EKV
basistaalvaardigheid	basistaalvaardigheid	ZNW:EKV
bazigheid	bazigheid	ZNW:EKV
bedrijfsaangelegenheid	bedrijfsaangelegenheid	ZNW:EKV
beeldloosheid	beeldloosheid	ZNW:EKV
begeerteloosheid	begeerteloosheid	ZNW:EKV
behandelbaarheid	behandelbaarheid	ZNW:EKV
beheerbaarheid	beheerbaarheid	ZNW:EKV
behoefteloosheid	behoefteloosheid	ZNW:EKV
bekostigingsverantwoordelijkheid	bekostigingsverantwoordelijkheid	ZNW:EKV
belastingplichtigheid	belastingplichtigheid	ZNW:EKV
beleefbaarheid	beleefbaarheid	ZNW:EKV
beleggerswijsheid	beleggerswijsheid	ZNW:EKV
beleidsdoelmatigheid	beleidsdoelmatigheid	ZNW:EKV
beloopbaarheid	beloopbaarheid	ZNW:EKV
benaderbaarheid	benaderbaarheid	ZNW:EKV
benieuwdheid	benieuwdheid	ZNW:EKV
benodigdheid	benodigdheid	ZNW:EKV
beproefdheid	beproefdheid	ZNW:EKV
berijdbaarheid	berijdbaarheid	ZNW:EKV
beroepsaangelegenheid	beroepsaangelegenheid	ZNW:EKV
beschavingsloosheid	beschavingsloosheid	ZNW:EKV
besluitloosheid	besluitloosheid	ZNW:EKV
bespeelbaarheid	bespeelbaarheid	ZNW:EKV
bestuurdersveiligheid	bestuurdersveiligheid	ZNW:EKV
bestuursaangelegenheid	bestuursaangelegenheid	ZNW:EKV
bestuursloosheid	bestuursloosheid	ZNW:EKV
beveiligingsverantwoordelijkheid	beveiligingsverantwoordelijkheid	ZNW:EKV
bevindelijkheid	bevindelijkheid	ZNW:EKV
bewaarbaarheid	bewaarbaarheid	ZNW:EKV
bewerkbaarheid	bewerkbaarheid	ZNW:EKV
bezitsloosheid	bezitsloosheid	ZNW:EKV
bezitterigheid	bezitterigheid	ZNW:EKV
bloederigheid	bloederigheid	ZNW:EKV
blogmoeheid	blogmoeheid	ZNW:EKV
bloheid	bloheid	ZNW:EKV
blootheid	blootheid	ZNW:EKV
bolheid	bolheid	ZNW:EKV
boomrijpheid	boomrijpheid	ZNW:EKV
bouwrijpheid	bouwrijpheid	ZNW:EKV
bouwvaardigheid	bouwvaardigheid	ZNW:EKV
brandwerendheid	brandwerendheid	ZNW:EKV
buiigheid	buiigheid	ZNW:EKV
burgeraangelegenheid	burgeraangelegenheid	ZNW:EKV
collegeaangelegenheid	collegeaangelegenheid	ZNW:EKV
commandantenverantwoordelijkheid	commandantenverantwoordelijkheid	ZNW:EKV
composteerbaarheid	composteerbaarheid	ZNW:EKV
contactloosheid	contactloosheid	ZNW:EKV
contextloosheid	contextloosheid	ZNW:EKV
contracteerbaarheid	contracteerbaarheid	ZNW:EKV
contractloosheid	contractloosheid	ZNW:EKV
coolheid	coolheid	ZNW:EKV
coulantheid	coulantheid	ZNW:EKV
courantheid	courantheid	ZNW:EKV
cultuurloosheid	cultuurloosheid	ZNW:EKV
cyberveiligheid	cyberveiligheid	ZNW:EKV
dadelijkheid	dadelijkheid	ZNW:EKV
deeltijdwerkloosheid	deeltijdwerkloosheid	ZNW:EKV
deelwaarheid	deelwaarheid	ZNW:EKV
desolaatheid	desolaatheid	ZNW:EKV
dienstaangelegenheid	dienstaangelegenheid	ZNW:EKV
diepgaandheid	diepgaandheid	ZNW:EKV
doelveiligheid	doelveiligheid	ZNW:EKV
doorleefdheid	doorleefdheid	ZNW:EKV
doorzoekbaarheid	doorzoekbaarheid	ZNW:EKV
dorpsaangelegenheid	dorpsaangelegenheid	ZNW:EKV
dorstloosheid	dorstloosheid	ZNW:EKV
doseerbaarheid	doseerbaarheid	ZNW:EKV
douaneaangelegenheid	douaneaangelegenheid	ZNW:EKV
draaglijkheid	draaglijkheid	ZNW:EKV
drachtigheid	drachtigheid	ZNW:EKV
drempelloosheid	drempelloosheid	ZNW:EKV
drievoudigheid	drievoudigheid	ZNW:EKV
drinkbaarheid	drinkbaarheid	ZNW:EKV
droevigheid	droevigheid	ZNW:EKV
druilerigheid	druilerigheid	ZNW:EKV
duikveiligheid	duikveiligheid	ZNW:EKV
dwarsigheid	dwarsigheid	ZNW:EKV
eenmansaangelegenheid	eenmansaangelegenheid	ZNW:EKV
eenmansminderheid	eenmansminderheid	ZNW:EKV
eindhardheid	eindhardheid	ZNW:EKV
eliteaangelegenheid	eliteaangelegenheid	ZNW:EKV
emotieloosheid	emotieloosheid	ZNW:EKV
energie-werkelijkheid	energie-werkelijkheid	ZNW:EKV
energieloosheid	energieloosheid	ZNW:EKV
enkelvoudigheid	enkelvoudigheid	ZNW:EKV
ergheid	ergheid	ZNW:EKV
ernstigheid	ernstigheid	ZNW:EKV
exporteerbaarheid	exporteerbaarheid	ZNW:EKV
faalveiligheid	faalveiligheid	ZNW:EKV
falsifieerbaarheid	falsifieerbaarheid	ZNW:EKV
familieloosheid	familieloosheid	ZNW:EKV
filtreerbaarheid	filtreerbaarheid	ZNW:EKV
foerageergelegenheid	foerageergelegenheid	ZNW:EKV
fractieaangelegenheid	fractieaangelegenheid	ZNW:EKV
fruitigheid	fruitigheid	ZNW:EKV
functieloosheid	functieloosheid	ZNW:EKV
geboeidheid	geboeidheid	ZNW:EKV
gebruikerszekerheid	gebruikerszekerheid	ZNW:EKV
geefbereidheid	geefbereidheid	ZNW:EKV
geest-persoonlijkheid	geest-persoonlijkheid	ZNW:EKV
geest-werkelijkheid	geest-werkelijkheid	ZNW:EKV
geestesbedrijvigheid	geestesbedrijvigheid	ZNW:EKV
geestesgezondheid	geestesgezondheid	ZNW:EKV
geesteswerkzaamheid	geesteswerkzaamheid	ZNW:EKV
geestloosheid	geestloosheid	ZNW:EKV
gefascineerdheid	gefascineerdheid	ZNW:EKV
gehaastheid	gehaastheid	ZNW:EKV
geheelheid	geheelheid	ZNW:EKV
geheid	geheid	BNW:STL:ONV
geheid	heien	WKW:VTD:ONV
geiligheid	geiligheid	ZNW:EKV
gekleurdheid	gekleurdheid	ZNW:EKV
gelijkberechtigdheid	gelijkberechtigdheid	ZNW:EKV
geluidsloosheid	geluidsloosheid	ZNW:EKV
gemakzuchtigheid	gemakzuchtigheid	ZNW:EKV
gemeenschapsverantwoordelijkheid	gemeenschapsverantwoordelijkheid	ZNW:EKV
genadigheid	genadigheid	ZNW:EKV
geobsedeerdheid	geobsedeerdheid	ZNW:EKV
gerieflijkheid	gerieflijkheid	ZNW:EKV
geschiedenisloosheid	geschiedenisloosheid	ZNW:EKV
geserreerdheid	geserreerdheid	ZNW:EKV
geslachtsloosheid	geslachtsloosheid	ZNW:EKV
gestemdheid	gestemdheid	ZNW:EKV
getiktheid	getiktheid	ZNW:EKV
gevaarloosheid	gevaarloosheid	ZNW:EKV
gevoelsaangelegenheid	gevoelsaangelegenheid	ZNW:EKV
gevoelsloosheid	gevoelsloosheid	ZNW:EKV
gewaserosiegevoeligheid	gewaserosiegevoeligheid	ZNW:EKV
geweldigheid	geweldigheid	ZNW:EKV
geweldsbereidheid	geweldsbereidheid	ZNW:EKV
geweldsloosheid	geweldsloosheid	ZNW:EKV
gewestaangelegenheid	gewestaangelegenheid	ZNW:EKV
gewetensloosheid	gewetensloosheid	ZNW:EKV
gewetensvolheid	gewetensvolheid	ZNW:EKV
gezagsloosheid	gezagsloosheid	ZNW:EKV
gezichtsloosheid	gezichtsloosheid	ZNW:EKV
gezinsaangelegenheid	gezinsaangelegenheid	ZNW:EKV
geïnvolveerdheid	geïnvolveerdheid	ZNW:EKV
glasnijverheid	glasnijverheid	ZNW:EKV
godsdienstloosheid	godsdienstloosheid	ZNW:EKV
goedlachsheid	goedlachsheid	ZNW:EKV
grensloosheid	grensloosheid	ZNW:EKV
grieperigheid	grieperigheid	ZNW:EKV
groepsaangelegenheid	groepsaangelegenheid	ZNW:EKV
haarloosheid	haarloosheid	ZNW:EKV
hanigheid	hanigheid	ZNW:EKV
hengstigheid	hengstigheid	ZNW:EKV
herenaangelegenheid	herenaangelegenheid	ZNW:EKV
hersengesteldheid	hersengesteldheid	ZNW:EKV
hersengezondheid	hersengezondheid	ZNW:EKV
hersenloosheid	hersenloosheid	ZNW:EKV
hersenmoeheid	hersenmoeheid	ZNW:EKV
hersenwerkzaamheid	hersenwerkzaamheid	ZNW:EKV
hijgerigheid	hijgerigheid	ZNW:EKV
hinderlijkheid	hinderlijkheid	ZNW:EKV
hipheid	hipheid	ZNW:EKV
hoefbevangenheid	hoefbevangenheid	ZNW:EKV
hoefgezondheid	hoefgezondheid	ZNW:EKV
hoeknauwkeurigheid	hoeknauwkeurigheid	ZNW:EKV
hoofdelijkheid	hoofdelijkheid	ZNW:EKV
hoornloosheid	hoornloosheid	ZNW:EKV
horeca-aangelegenheid	horeca-aangelegenheid	ZNW:EKV
horkerigheid	horkerigheid	ZNW:EKV
huisveiligheid	huisveiligheid	ZNW:EKV
hulpbereidheid	hulpbereidheid	ZNW:EKV
hulploosheid	hulploosheid	ZNW:EKV
hyperwerkelijkheid	hyperwerkelijkheid	ZNW:EKV
identificeerbaarheid	identificeerbaarheid	ZNW:EKV
identiteitsloosheid	identiteitsloosheid	ZNW:EKV
ijshardheid	ijshardheid	ZNW:EKV
illegaalheid	illegaalheid	ZNW:EKV
incourantheid	incourantheid	ZNW:EKV
indexeerbaarheid	indexeerbaarheid	ZNW:EKV
ingeheid	inheien	WKW:VTD:ONV
ingenieurswijsheid	ingenieurswijsheid	ZNW:EKV
ingrijpendheid	ingrijpendheid	ZNW:EKV
initiatiefloosheid	initiatiefloosheid	ZNW:EKV
instelbaarheid	instelbaarheid	ZNW:EKV
instinctloosheid	instinctloosheid	ZNW:EKV
instrumenteerbaarheid	instrumenteerbaarheid	ZNW:EKV
integerheid	integerheid	ZNW:EKV
integreerbaarheid	integreerbaarheid	ZNW:EKV
interessantheid	interessantheid	ZNW:EKV
interesseloosheid	interesseloosheid	ZNW:EKV
interferentiegevoeligheid	interferentiegevoeligheid	ZNW:EKV
interpreteerbaarheid	interpreteerbaarheid	ZNW:EKV
intronisatieplechtigheid	intronisatieplechtigheid	ZNW:EKV
jagerswijsheid	jagerswijsheid	ZNW:EKV
jazzgelegenheid	jazzgelegenheid	ZNW:EKV
jongensaangelegenheid	jongensaangelegenheid	ZNW:EKV
jongheid	jongheid	ZNW:EKV
kabinetsaangelegenheid	kabinetsaangelegenheid	ZNW:EKV
kantnijverheid	kantnijverheid	ZNW:EKV
kapitaaltoereikendheid	kapitaaltoereikendheid	ZNW:EKV
kennisloosheid	kennisloosheid	ZNW:EKV
ketenaangelegenheid	ketenaangelegenheid	ZNW:EKV
ketenklanttevredenheid	ketenklanttevredenheid	ZNW:EKV
keuzeloosheid	keuzeloosheid	ZNW:EKV
kitscherigheid	kitscherigheid	ZNW:EKV
klagerigheid	klagerigheid	ZNW:EKV
kleur-echtheid	kleur-echtheid	ZNW:EKV
knapperigheid	knapperigheid	ZNW:EKV
koersloosheid	koersloosheid	ZNW:EKV
koninkrijksaangelegenheid	koninkrijksaangelegenheid	ZNW:EKV
koopkrachtzekerheid	koopkrachtzekerheid	ZNW:EKV
kostendekkendheid	kostendekkendheid	ZNW:EKV
kringerigheid	kringerigheid	ZNW:EKV
krolsheid	krolsheid	ZNW:EKV
lactoseovergevoeligheid	lactoseovergevoeligheid	ZNW:EKV
laksigheid	laksigheid	ZNW:EKV
langetermijnverantwoordelijkheid	langetermijnverantwoordelijkheid	ZNW:EKV
lawaaierigheid	lawaaierigheid	ZNW:EKV
leergelegenheid	leergelegenheid	ZNW:EKV
letterlijkheid	letterlijkheid	ZNW:EKV
levenloosheid	levenloosheid	ZNW:EKV
leverbaarheid	leverbaarheid	ZNW:EKV
lichtgelijkmatigheid	lichtgelijkmatigheid	ZNW:EKV
lichtloosheid	lichtloosheid	ZNW:EKV
lijmhoeveelheid	lijmhoeveelheid	ZNW:EKV
maatgerichtheid	maatgerichtheid	ZNW:EKV
makkelijkheid	makkelijkheid	ZNW:EKV
mandeligheid	mandeligheid	ZNW:EKV
mannenaangelegenheid	mannenaangelegenheid	ZNW:EKV
manoeuvreerbaarheid	manoeuvreerbaarheid	ZNW:EKV
manoeuvreervaardigheid	manoeuvreervaardigheid	ZNW:EKV
marine-overheid	marine-overheid	ZNW:EKV
massa-aangelegenheid	massa-aangelegenheid	ZNW:EKV
massa-traagheid	massa-traagheid	ZNW:EKV
medewerkersveiligheid	medewerkersveiligheid	ZNW:EKV
media-aangelegenheid	media-aangelegenheid	ZNW:EKV
meeneembaarheid	meeneembaarheid	ZNW:EKV
meerheid	meerheid	ZNW:EKV
meetgrootheid	meetgrootheid	ZNW:EKV
melkbaarheid	melkbaarheid	ZNW:EKV
mengbaarheid	mengbaarheid	ZNW:EKV
mensenaangelegenheid	mensenaangelegenheid	ZNW:EKV
merkbaarheid	merkbaarheid	ZNW:EKV
merkgeilheid	merkgeilheid	ZNW:EKV
mini-minderheid	mini-minderheid	ZNW:EKV
moederloosheid	moederloosheid	ZNW:EKV
monsterlijkheid	monsterlijkheid	ZNW:EKV
moraalloosheid	moraalloosheid	ZNW:EKV
naamloosheid	naamloosheid	ZNW:EKV
naspeurbaarheid	naspeurbaarheid	ZNW:EKV
nastelbaarheid	nastelbaarheid	ZNW:EKV
niveaugelijkwaardigheid	niveaugelijkwaardigheid	ZNW:EKV
niveauloosheid	niveauloosheid	ZNW:EKV
objectloosheid	objectloosheid	ZNW:EKV
olieonafhankelijkheid	olieonafhankelijkheid	ZNW:EKV
onafheid	onafheid	ZNW:EKV
onbemiddeldheid	onbemiddeldheid	UNSPECIFIED
onbespeelbaarheid	onbespeelbaarheid	ZNW:EKV
onbestemdheid	onbestemdheid	ZNW:EKV
ondernemendheid	ondernemendheid	ZNW:EKV
ongeconcentreerdheid	ongeconcentreerdheid	ZNW:EKV
ongecontroleerdheid	ongecontroleerdheid	ZNW:EKV
ongedeeldheid	ongedeeldheid	ZNW:EKV
ongelukkigheid	ongelukkigheid	ZNW:EKV
ongeremdheid	ongeremdheid	ZNW:EKV
ongeschondenheid	ongeschondenheid	ZNW:EKV
ongevalsbetrokkenheid	ongevalsbetrokkenheid	ZNW:EKV
onhuiselijkheid	onhuiselijkheid	UNSPECIFIED
oninbaarheid	oninbaarheid	ZNW:EKV
online-aanwezigheid	online-aanwezigheid	ZNW:EKV
onmiddelijkheid	onmiddelijkheid	ZNW:EKV
onschuldigheid	onschuldigheid	ZNW:EKV
ontheemdheid	ontheemdheid	ZNW:EKV
ontworteldheid	ontworteldheid	ZNW:EKV
onverbeterlijkheid	onverbeterlijkheid	UNSPECIFIED
onvervangbaarheid	onvervangbaarheid	ZNW:EKV
onverwijldheid	onverwijldheid	ZNW:EKV
onverwoestbaarheid	onverwoestbaarheid	ZNW:EKV
onverzoenbaarheid	onverzoenbaarheid	ZNW:EKV
onvolwaardigheid	onvolwaardigheid	ZNW:EKV
onvoorstelbaarheid	onvoorstelbaarheid	ZNW:EKV
onvoorzienbaarheid	onvoorzienbaarheid	ZNW:EKV
ooggevoeligheid	ooggevoeligheid	ZNW:EKV
oordeelloosheid	oordeelloosheid	ZNW:EKV
opmerkelijkheid	opmerkelijkheid	ZNW:EKV
opneembaarheid	opneembaarheid	ZNW:EKV
oppositieaangelegenheid	oppositieaangelegenheid	ZNW:EKV
opspoorbaarheid	opspoorbaarheid	ZNW:EKV
opvallendheid	opvallendheid	ZNW:EKV
ouderloosheid	ouderloosheid	ZNW:EKV
overdrachtelijkheid	overdrachtelijkheid	ZNW:EKV
paarbereidheid	paarbereidheid	ZNW:EKV
partijaangelegenheid	partijaangelegenheid	ZNW:EKV
passeerbaarheid	passeerbaarheid	ZNW:EKV
passendheid	passendheid	ZNW:EKV
patenteerbaarheid	patenteerbaarheid	ZNW:EKV
perspectiefloosheid	perspectiefloosheid	ZNW:EKV
pijnloosheid	pijnloosheid	ZNW:EKV
plaatsbaarheid	plaatsbaarheid	ZNW:EKV
plakkerigheid	plakkerigheid	ZNW:EKV
plasgelegenheid	plasgelegenheid	ZNW:EKV
plattelandsnijverheid	plattelandsnijverheid	ZNW:EKV
politieaangelegenheid	politieaangelegenheid	ZNW:EKV
polsloosheid	polsloosheid	ZNW:EKV
post-apartheid	post-apartheid	ZNW:EKV
prikkelloosheid	prikkelloosheid	ZNW:EKV
principeloosheid	principeloosheid	ZNW:EKV
probleemloosheid	probleemloosheid	ZNW:EKV
raakheid	raakheid	ZNW:EKV
radheid	radheid	ZNW:EKV
rafelingsgevoeligheid	rafelingsgevoeligheid	ZNW:EKV
rapheid	rapheid	ZNW:EKV
rapporteerbaarheid	rapporteerbaarheid	ZNW:EKV
rasgevoeligheid	rasgevoeligheid	ZNW:EKV
reactieloosheid	reactieloosheid	ZNW:EKV
realiseerbaarheid	realiseerbaarheid	ZNW:EKV
rechtgelijkheid	rechtgelijkheid	ZNW:EKV
rechtsstatelijkheid	rechtsstatelijkheid	ZNW:EKV
rechtstatelijkheid	rechtstatelijkheid	ZNW:EKV
regelbaarheid	regelbaarheid	ZNW:EKV
regeringsloosheid	regeringsloosheid	ZNW:EKV
reinigbaarheid	reinigbaarheid	ZNW:EKV
reisbereidheid	reisbereidheid	ZNW:EKV
reisvaardigheid	reisvaardigheid	ZNW:EKV
reizigerstevredenheid	reizigerstevredenheid	ZNW:EKV
reizigersveiligheid	reizigersveiligheid	ZNW:EKV
reizigerswijsheid	reizigerswijsheid	ZNW:EKV
religieloosheid	religieloosheid	ZNW:EKV
remediëringsdeskundigheid	remediëringsdeskundigheid	ZNW:EKV
renteloosheid	renteloosheid	ZNW:EKV
repeteernauwkeurigheid	repeteernauwkeurigheid	ZNW:EKV
respecteerbaarheid	respecteerbaarheid	ZNW:EKV
restbekwaamheid	restbekwaamheid	ZNW:EKV
restvochtigheid	restvochtigheid	ZNW:EKV
resultaatloosheid	resultaatloosheid	ZNW:EKV
richtingsloosheid	richtingsloosheid	ZNW:EKV
richtluchtvochtigheid	richtluchtvochtigheid	ZNW:EKV
rijksaangelegenheid	rijksaangelegenheid	ZNW:EKV
rillerigheid	rillerigheid	ZNW:EKV
rimpelloosheid	rimpelloosheid	ZNW:EKV
risicoloosheid	risicoloosheid	ZNW:EKV
rondborstigheid	rondborstigheid	ZNW:EKV
roofgierigheid	roofgierigheid	ZNW:EKV
rookgelegenheid	rookgelegenheid	ZNW:EKV
rotheid	rotheid	ZNW:EKV
routineaangelegenheid	routineaangelegenheid	ZNW:EKV
rundergezondheid	rundergezondheid	ZNW:EKV
schadeloosheid	schadeloosheid	ZNW:EKV
schofterigheid	schofterigheid	ZNW:EKV
schoolmeesterswijsheid	schoolmeesterswijsheid	ZNW:EKV
schriftelijkheid	schriftelijkheid	ZNW:EKV
schrijnendheid	schrijnendheid	ZNW:EKV
schuldigheid	schuldigheid	ZNW:EKV
sekse-apartheid	sekse-apartheid	ZNW:EKV
seksegelijkwaardigheid	seksegelijkwaardigheid	ZNW:EKV
slaaploosheid	slaaploosheid	ZNW:EKV
slibhoeveelheid	slibhoeveelheid	ZNW:EKV
smaakloosheid	smaakloosheid	ZNW:EKV
sneuheid	sneuheid	ZNW:EKV
snijrijpheid	snijrijpheid	ZNW:EKV
snotverkoudheid	snotverkoudheid	ZNW:EKV
solo-aangelegenheid	solo-aangelegenheid	ZNW:EKV
spanningsloosheid	spanningsloosheid	ZNW:EKV
speelbaarheid	speelbaarheid	ZNW:EKV
spoedeisendheid	spoedeisendheid	ZNW:EKV
spoorloosheid	spoorloosheid	ZNW:EKV
staartloosheid	staartloosheid	ZNW:EKV
staatsloosheid	staatsloosheid	ZNW:EKV
stadsaangelegenheid	stadsaangelegenheid	ZNW:EKV
status-geilheid	status-geilheid	ZNW:EKV
stekelachtigheid	stekelachtigheid	UNSPECIFIED
stelvaardigheid	stelvaardigheid	ZNW:EKV
stemloosheid	stemloosheid	ZNW:EKV
stofhoeveelheid	stofhoeveelheid	ZNW:EKV
stolbaarheid	stolbaarheid	ZNW:EKV
stressloosheid	stressloosheid	ZNW:EKV
strijdloosheid	strijdloosheid	ZNW:EKV
strijdlustigheid	strijdlustigheid	ZNW:EKV
structuurloosheid	structuurloosheid	ZNW:EKV
studietaalvaardigheid	studietaalvaardigheid	ZNW:EKV
stuurbaarheid	stuurbaarheid	ZNW:EKV
systeemloosheid	systeemloosheid	ZNW:EKV
taalgelijkheid	taalgelijkheid	ZNW:EKV
taalgerichtheid	taalgerichtheid	ZNW:EKV
taalmeerderheid	taalmeerderheid	ZNW:EKV
taalzelfstandigheid	taalzelfstandigheid	ZNW:EKV
talentloosheid	talentloosheid	ZNW:EKV
tegeltjeswaarheid	tegeltjeswaarheid	ZNW:EKV
testbereidheid	testbereidheid	ZNW:EKV
testgelegenheid	testgelegenheid	ZNW:EKV
testgevoeligheid	testgevoeligheid	ZNW:EKV
testhoeveelheid	testhoeveelheid	ZNW:EKV
tijdingloosheid	tijdingloosheid	ZNW:EKV
tijdsloosheid	tijdsloosheid	ZNW:EKV
toekomstloosheid	toekomstloosheid	ZNW:EKV
toereikendheid	toereikendheid	ZNW:EKV
toetsbaarheid	toetsbaarheid	ZNW:EKV
toewijsbaarheid	toewijsbaarheid	ZNW:EKV
tolkvaardigheid	tolkvaardigheid	ZNW:EKV
toogwijsheid	toogwijsheid	ZNW:EKV
toondoofheid	toondoofheid	ZNW:EKV
transfereerbaarheid	transfereerbaarheid	ZNW:EKV
transporteerbaarheid	transporteerbaarheid	ZNW:EKV
trimvaardigheid	trimvaardigheid	ZNW:EKV
triomfantelijkheid	triomfantelijkheid	ZNW:EKV
twijfelloosheid	twijfelloosheid	ZNW:EKV
uitdrukkingsloosheid	uitdrukkingsloosheid	ZNW:EKV
uitwonendheid	uitwonendheid	ZNW:EKV
vaargelegenheid	vaargelegenheid	ZNW:EKV
veegvastheid	veegvastheid	ZNW:EKV
veelgezondheid	veelgezondheid	ZNW:EKV
veelkoppigheid	veelkoppigheid	ZNW:EKV
veelomvattendheid	veelomvattendheid	ZNW:EKV
veelstemmigheid	veelstemmigheid	ZNW:EKV
veelvoudigheid	veelvoudigheid	ZNW:EKV
veerveiligheid	veerveiligheid	ZNW:EKV
veiligheidsaangelegenheid	veiligheidsaangelegenheid	ZNW:EKV
veranderbaarheid	veranderbaarheid	ZNW:EKV
verantwoordingsloosheid	verantwoordingsloosheid	ZNW:EKV
verdedigingsloosheid	verdedigingsloosheid	ZNW:EKV
verdraagbaarheid	verdraagbaarheid	ZNW:EKV
verenigingsaangelegenheid	verenigingsaangelegenheid	ZNW:EKV
verfhoeveelheid	verfhoeveelheid	ZNW:EKV
vergeeflijkheid	vergeeflijkheid	UNSPECIFIED
verhaalbaarheid	verhaalbaarheid	ZNW:EKV
vernietigbaarheid	vernietigbaarheid	ZNW:EKV
verschuldigdheid	verschuldigdheid	ZNW:EKV
vervangbaarheid	vervangbaarheid	ZNW:EKV
vervormbaarheid	vervormbaarheid	ZNW:EKV
verwisselbaarheid	verwisselbaarheid	ZNW:EKV
verzekeringsaangelegenheid	verzekeringsaangelegenheid	ZNW:EKV
verzetsloosheid	verzetsloosheid	ZNW:EKV
verzuildheid	verzuildheid	ZNW:EKV
visieloosheid	visieloosheid	ZNW:EKV
vleesloosheid	vleesloosheid	ZNW:EKV
vleugelloosheid	vleugelloosheid	ZNW:EKV
voeghardheid	voeghardheid	ZNW:EKV
voerhoeveelheid	voerhoeveelheid	ZNW:EKV
volkshuisvestingsverantwoordelijkheid	volkshuisvestingsverantwoordelijkheid	ZNW:EKV
voorleesbaarheid	voorleesbaarheid	ZNW:EKV
voorwaardelijkheid	voorwaardelijkheid	ZNW:EKV
voorzienbaarheid	voorzienbaarheid	ZNW:EKV
vormschoonheid	vormschoonheid	ZNW:EKV
vormselplechtigheid	vormselplechtigheid	ZNW:EKV
vormstijfheid	vormstijfheid	ZNW:EKV
vormzuiverheid	vormzuiverheid	ZNW:EKV
vredeloosheid	vredeloosheid	ZNW:EKV
vreesloosheid	vreesloosheid	ZNW:EKV
vreugdeloosheid	vreugdeloosheid	ZNW:EKV
vrouwenaangelegenheid	vrouwenaangelegenheid	ZNW:EKV
warmwaterhoeveelheid	warmwaterhoeveelheid	ZNW:EKV
waterspeelgelegenheid	waterspeelgelegenheid	ZNW:EKV
weeheid	weeheid	ZNW:EKV
weifelachtigheid	weifelachtigheid	ZNW:EKV
werkheiligheid	werkheiligheid	ZNW:EKV
werkhoeveelheid	werkhoeveelheid	ZNW:EKV
werknemersgezondheid	werknemersgezondheid	ZNW:EKV
werkveiligheid	werkveiligheid	ZNW:EKV
wetsongelijkheid	wetsongelijkheid	ZNW:EKV
wielergrootheid	wielergrootheid	ZNW:EKV
wielerwijsheid	wielerwijsheid	ZNW:EKV
wijkgerichtheid	wijkgerichtheid	ZNW:EKV
wilsbekwaamheid	wilsbekwaamheid	ZNW:EKV
winbaarheid	winbaarheid	ZNW:EKV
wisheid	wisheid	ZNW:EKV
woordloosheid	woordloosheid	ZNW:EKV
worteldoorgroeibestendigheid	worteldoorgroeibestendigheid	ZNW:EKV
zatheid	zatheid	ZNW:EKV
zeurderigheid	zeurderigheid	ZNW:EKV
zielloosheid	zielloosheid	ZNW:EKV
zintuiglijkheid	zintuiglijkheid	ZNW:EKV
zoekmachine-moeheid	zoekmachine-moeheid	ZNW:EKV
zoetelijkheid	zoetelijkheid	ZNW:EKV
zoetwaterhoeveelheid	zoetwaterhoeveelheid	ZNW:EKV
zompigheid	zompigheid	ZNW:EKV
zonnewerkzaamheid	zonnewerkzaamheid	ZNW:EKV
zuurstofloosheid	zuurstofloosheid	ZNW:EKV
zwaarteloosheid	zwaarteloosheid	ZNW:EKV
zwemveiligheid	zwemveiligheid	ZNW:EKV
acquisitievaardigheid	acquisitievaardigheid	ZNW:EKV
bewaarheid	bewaarheiden	WKW:TGW:1EP
onderheid	onderheien	WKW:VTD:ONV
vloeiendheid	vloeiendheid	ZNW:EKV
verlengbaarheid	verlengbaarheid	BNW:STL:ONV
staatloosheid	staatloosheid	ZNW:EKV
romigheid	romigheid	ZNW:EKV
andersheid	andersheid	ZNW:EKV
volhardendheid	volhardendheid	ZNW:EKV
getraindheid	getraindheid	ZNW:EKV
rebelsheid	rebelsheid	ZNW:EKV
lasbaarheid	lasbaarheid	ZNW:EKV
lolligheid	lolligheid	ZNW:EKV
rokerigheid	rokerigheid	ZNW:EKV
mankheid	mankheid	ZNW:EKV
zonnigheid	zonnigheid	ZNW:EKV
ruimheid	ruimheid	ZNW:EKV
gecijferdheid	gecijferdheid	ZNW:EKV
warrigheid	warrigheid	ZNW:EKV
heiigheid	heiigheid	ZNW:EKV
vlezigheid	vlezigheid	ZNW:EKV
warsheid	warsheid	ZNW:EKV
nepheid	nepheid	ZNW:EKV
mafheid	mafheid	ZNW:EKV
tofheid	tofheid	ZNW:EKV
foutheid	foutheid	ZNW:EKV
geelheid	geelheid	ZNW:EKV
heetheid	heetheid	ZNW:EKV
veeleisendheid	veeleisendheid	ZNW:EKV
haaksheid	haaksheid	ZNW:EKV
vroegheid	vroegheid	ZNW:EKV
procesverantwoordelijkheid	procesverantwoordelijkheid	ZNW:EKV
basisbenodigdheid	basisbenodigdheid	ZNW:EKV
buurtaangelegenheid	buurtaangelegenheid	ZNW:EKV
personeelsaangelegenheid	personeelsaangelegenheid	ZNW:EKV
wereldaangelegenheid	wereldaangelegenheid	ZNW:EKV
jazz-grootheid	jazz-grootheid	ZNW:EKV
jazzgrootheid	jazzgrootheid	ZNW:EKV
collega-overheid	collega-overheid	ZNW:EKV
mede-overheid	mede-overheid	ZNW:EKV
begaanheid	begaanheid	BNW:STL:ONV
onbekrompenheid	onbekrompenheid	ZNW:EKV
aanhangigheid	aanhangigheid	UNSPECIFIED
aanstuurbaarheid	aanstuurbaarheid	ZNW:EKV
acuutheid	acuutheid	UNSPECIFIED
adellijkheid	adellijkheid	UNSPECIFIED
afgestomptheid	afgestomptheid	UNSPECIFIED
afwasbaarheid	afwasbaarheid	UNSPECIFIED
almachtigheid	almachtigheid	UNSPECIFIED
autoluwheid	autoluwheid	UNSPECIFIED
beboetbaarheid	beboetbaarheid	UNSPECIFIED
beheptheid	beheptheid	UNSPECIFIED
bejaardheid	bejaardheid	UNSPECIFIED
bekaktheid	bekaktheid	UNSPECIFIED
benutbaarheid	benutbaarheid	UNSPECIFIED
bepaalbaarheid	bepaalbaarheid	UNSPECIFIED
beslisbaarheid	beslisbaarheid	UNSPECIFIED
bevisbaarheid	bevisbaarheid	UNSPECIFIED
bezwarendheid	bezwarendheid	UNSPECIFIED
bijterigheid	bijterigheid	UNSPECIFIED
bindendheid	bindendheid	UNSPECIFIED
blikkerigheid	blikkerigheid	UNSPECIFIED
bouwbaarheid	bouwbaarheid	UNSPECIFIED
bozigheid	bozigheid	UNSPECIFIED
briljantheid	briljantheid	UNSPECIFIED
bruinheid	bruinheid	UNSPECIFIED
chagrijnigheid	chagrijnigheid	UNSPECIFIED
denkbaarheid	denkbaarheid	UNSPECIFIED
dichtbijheid	dichtbijheid	UNSPECIFIED
diffuusheid	diffuusheid	UNSPECIFIED
doenbaarheid	doenbaarheid	UNSPECIFIED
doezeligheid	doezeligheid	UNSPECIFIED
doordrinkbaarheid	doordrinkbaarheid	ZNW:EKV
doorwrochtheid	doorwrochtheid	UNSPECIFIED
dorpsheid	dorpsheid	UNSPECIFIED
draaibaarheid	draaibaarheid	UNSPECIFIED
drukheid	drukheid	UNSPECIFIED
egaalheid	egaalheid	UNSPECIFIED
eigenlijkheid	eigenlijkheid	UNSPECIFIED
eisbaarheid	eisbaarheid	UNSPECIFIED
ervaarbaarheid	ervaarbaarheid	UNSPECIFIED
explicietheid	explicietheid	UNSPECIFIED
fairheid	fairheid	UNSPECIFIED
faseerbaarheid	faseerbaarheid	UNSPECIFIED
flexibelheid	flexibelheid	UNSPECIFIED
fluweligheid	fluweligheid	UNSPECIFIED
fotogeniekheid	fotogeniekheid	UNSPECIFIED
fysiekheid	fysiekheid	UNSPECIFIED
galantheid	galantheid	UNSPECIFIED
gammelheid	gammelheid	UNSPECIFIED
geagiteerdheid	geagiteerdheid	UNSPECIFIED
geforceerdheid	geforceerdheid	UNSPECIFIED
gehaaidheid	gehaaidheid	UNSPECIFIED
gekendheid	gekendheid	UNSPECIFIED
gelieerdheid	gelieerdheid	UNSPECIFIED
geliefdheid	geliefdheid	UNSPECIFIED
gelukkigheid	gelukkigheid	UNSPECIFIED
gemengdheid	gemengdheid	UNSPECIFIED
gemiddeldheid	gemiddeldheid	UNSPECIFIED
gemêleerdheid	gemêleerdheid	UNSPECIFIED
geschiftheid	geschiftheid	UNSPECIFIED
geslaagdheid	geslaagdheid	UNSPECIFIED
gestrektheid	gestrektheid	UNSPECIFIED
getraptheid	getraptheid	UNSPECIFIED
gevorderdheid	gevorderdheid	UNSPECIFIED
gietbaarheid	gietbaarheid	UNSPECIFIED
grassigheid	grassigheid	UNSPECIFIED
grauwigheid	grauwigheid	UNSPECIFIED
grijpbaarheid	grijpbaarheid	UNSPECIFIED
grofmazigheid	grofmazigheid	UNSPECIFIED
gronderigheid	gronderigheid	UNSPECIFIED
haastigheid	haastigheid	UNSPECIFIED
hardbaarheid	hardbaarheid	UNSPECIFIED
hedendaagsheid	hedendaagsheid	UNSPECIFIED
hongerigheid	hongerigheid	UNSPECIFIED
hoogstaandheid	hoogstaandheid	UNSPECIFIED
huilerigheid	huilerigheid	UNSPECIFIED
ijverigheid	ijverigheid	UNSPECIFIED
immensheid	immensheid	UNSPECIFIED
inadequaatheid	inadequaatheid	UNSPECIFIED
incompleetheid	incompleetheid	UNSPECIFIED
indrukbaarheid	indrukbaarheid	UNSPECIFIED
inertheid	inertheid	UNSPECIFIED
ingekeerdheid	ingekeerdheid	UNSPECIFIED
ingenieusheid	ingenieusheid	UNSPECIFIED
inroepbaarheid	inroepbaarheid	UNSPECIFIED
introvertheid	introvertheid	UNSPECIFIED
invoelbaarheid	invoelbaarheid	UNSPECIFIED
invulbaarheid	invulbaarheid	UNSPECIFIED
inwendigheid	inwendigheid	UNSPECIFIED
joodsheid	joodsheid	UNSPECIFIED
kalmheid	kalmheid	UNSPECIFIED
kenmerkendheid	kenmerkendheid	UNSPECIFIED
kerksheid	kerksheid	UNSPECIFIED
kinderrijkheid	kinderrijkheid	UNSPECIFIED
klammigheid	klammigheid	UNSPECIFIED
kloterigheid	kloterigheid	UNSPECIFIED
koninklijkheid	koninklijkheid	UNSPECIFIED
koppelbaarheid	koppelbaarheid	UNSPECIFIED
kortbenigheid	kortbenigheid	UNSPECIFIED
krachtigheid	krachtigheid	UNSPECIFIED
langgerektheid	langgerektheid	UNSPECIFIED
langlevendheid	langlevendheid	UNSPECIFIED
lekkerheid	lekkerheid	UNSPECIFIED
leutigheid	leutigheid	UNSPECIFIED
losbolligheid	losbolligheid	UNSPECIFIED
machtigheid	machtigheid	UNSPECIFIED
mallotigheid	mallotigheid	UNSPECIFIED
meercelligheid	meercelligheid	UNSPECIFIED
meerlagigheid	meerlagigheid	UNSPECIFIED
misbaarheid	misbaarheid	UNSPECIFIED
misplaatstheid	misplaatstheid	UNSPECIFIED
moutigheid	moutigheid	UNSPECIFIED
naleefbaarheid	naleefbaarheid	UNSPECIFIED
navolgbaarheid	navolgbaarheid	UNSPECIFIED
nichterigheid	nichterigheid	UNSPECIFIED
normaalheid	normaalheid	UNSPECIFIED
notigheid	notigheid	UNSPECIFIED
omstredenheid	omstredenheid	UNSPECIFIED
onbegrepenheid	onbegrepenheid	UNSPECIFIED
onbeheerstheid	onbeheerstheid	UNSPECIFIED
onbereidheid	onbereidheid	UNSPECIFIED
onbesnedenheid	onbesnedenheid	UNSPECIFIED
ondenkbaarheid	ondenkbaarheid	UNSPECIFIED
onderkoeldheid	onderkoeldheid	UNSPECIFIED
ongeborgenheid	ongeborgenheid	UNSPECIFIED
ongehechtheid	ongehechtheid	UNSPECIFIED
ongeordendheid	ongeordendheid	UNSPECIFIED
ongerichtheid	ongerichtheid	UNSPECIFIED
ongestoordheid	ongestoordheid	UNSPECIFIED
ongetraindheid	ongetraindheid	UNSPECIFIED
ongevormdheid	ongevormdheid	UNSPECIFIED
onkundigheid	onkundigheid	UNSPECIFIED
onmaakbaarheid	onmaakbaarheid	UNSPECIFIED
onpeilbaarheid	onpeilbaarheid	UNSPECIFIED
onterechtheid	onterechtheid	UNSPECIFIED
onverzorgdheid	onverzorgdheid	UNSPECIFIED
onvlakheid	onvlakheid	UNSPECIFIED
onzakelijkheid	onzakelijkheid	UNSPECIFIED
onzaligheid	onzaligheid	UNSPECIFIED
onzegbaarheid	onzegbaarheid	UNSPECIFIED
oogstbaarheid	oogstbaarheid	UNSPECIFIED
openlijkheid	openlijkheid	UNSPECIFIED
oproepbaarheid	oproepbaarheid	UNSPECIFIED
opvoedbaarheid	opvoedbaarheid	UNSPECIFIED
opvouwbaarheid	opvouwbaarheid	UNSPECIFIED
opzegbaarheid	opzegbaarheid	UNSPECIFIED
overspeligheid	overspeligheid	UNSPECIFIED
paniekerigheid	paniekerigheid	UNSPECIFIED
patserigheid	patserigheid	UNSPECIFIED
perfectheid	perfectheid	UNSPECIFIED
pikantheid	pikantheid	UNSPECIFIED
pissigheid	pissigheid	UNSPECIFIED
planbaarheid	planbaarheid	UNSPECIFIED
pluizigheid	pluizigheid	UNSPECIFIED
poenerigheid	poenerigheid	UNSPECIFIED
pompeusheid	pompeusheid	UNSPECIFIED
popperigheid	popperigheid	UNSPECIFIED
prachtigheid	prachtigheid	UNSPECIFIED
raakbaarheid	raakbaarheid	UNSPECIFIED
recentheid	recentheid	UNSPECIFIED
rechtsheid	rechtsheid	UNSPECIFIED
repliceerbaarheid	repliceerbaarheid	ZNW:EKV:HET
reusachtigheid	reusachtigheid	UNSPECIFIED
rozigheid	rozigheid	UNSPECIFIED
rustgevendheid	rustgevendheid	UNSPECIFIED
scanbaarheid	scanbaarheid	UNSPECIFIED
schandaligheid	schandaligheid	UNSPECIFIED
scheidbaarheid	scheidbaarheid	UNSPECIFIED
schijterigheid	schijterigheid	UNSPECIFIED
schilferigheid	schilferigheid	UNSPECIFIED
schokkerigheid	schokkerigheid	UNSPECIFIED
schuinheid	schuinheid	UNSPECIFIED
secuurheid	secuurheid	UNSPECIFIED
snotterigheid	snotterigheid	UNSPECIFIED
speciaalheid	speciaalheid	UNSPECIFIED
specifiekheid	specifiekheid	UNSPECIFIED
splijtbaarheid	splijtbaarheid	UNSPECIFIED
springerigheid	springerigheid	UNSPECIFIED
stiekemheid	stiekemheid	UNSPECIFIED
stonedheid	stonedheid	UNSPECIFIED
stralendheid	stralendheid	UNSPECIFIED
streberigheid	streberigheid	UNSPECIFIED
streperigheid	streperigheid	UNSPECIFIED
strooibaarheid	strooibaarheid	UNSPECIFIED
tijdrovendheid	tijdrovendheid	UNSPECIFIED
toegewijdheid	toegewijdheid	UNSPECIFIED
toekomstigheid	toekomstigheid	UNSPECIFIED
toonbaarheid	toonbaarheid	UNSPECIFIED
totaalheid	totaalheid	UNSPECIFIED
trekkerigheid	trekkerigheid	UNSPECIFIED
tweebenigheid	tweebenigheid	UNSPECIFIED
tweesporigheid	tweesporigheid	UNSPECIFIED
tweevoudigheid	tweevoudigheid	UNSPECIFIED
uitgeputheid	uitgeputheid	UNSPECIFIED
uitlegbaarheid	uitlegbaarheid	UNSPECIFIED
uitputbaarheid	uitputbaarheid	UNSPECIFIED
vangbaarheid	vangbaarheid	UNSPECIFIED
veelkantigheid	veelkantigheid	UNSPECIFIED
vergunbaarheid	vergunbaarheid	UNSPECIFIED
verstoktheid	verstoktheid	UNSPECIFIED
vervelendheid	vervelendheid	UNSPECIFIED
viersporigheid	viersporigheid	UNSPECIFIED
voelbaarheid	voelbaarheid	UNSPECIFIED
volgroeidheid	volgroeidheid	UNSPECIFIED
voltalligheid	voltalligheid	UNSPECIFIED
voorlijkheid	voorlijkheid	UNSPECIFIED
wanhopigheid	wanhopigheid	UNSPECIFIED
weidelijkheid	weidelijkheid	UNSPECIFIED
welgevormdheid	welgevormdheid	UNSPECIFIED
welriekendheid	welriekendheid	UNSPECIFIED
wereldlijkheid	wereldlijkheid	UNSPECIFIED
wijsneuzigheid	wijsneuzigheid	UNSPECIFIED
woordeloosheid	woordeloosheid	UNSPECIFIED
wormstekigheid	wormstekigheid	UNSPECIFIED
zanderigheid	zanderigheid	UNSPECIFIED
zeikerigheid	zeikerigheid	UNSPECIFIED
zingbaarheid	zingbaarheid	UNSPECIFIED
zoutigheid	zoutigheid	UNSPECIFIED
zweterigheid	zweterigheid	UNSPECIFIED
uitdagendheid	uitdagendheid	UNSPECIFIED
hoppigheid	hoppigheid	UNSPECIFIED
vlagerigheid	vlagerigheid	UNSPECIFIED
mineraligheid	mineraligheid	UNSPECIFIED
hyperigheid	hyperigheid	UNSPECIFIED
tweepoligheid	tweepoligheid	UNSPECIFIED
tranerigheid	tranerigheid	UNSPECIFIED
niksigheid	niksigheid	UNSPECIFIED
nikserigheid	nikserigheid	UNSPECIFIED
hippigheid	hippigheid	UNSPECIFIED
blijvendheid	blijvendheid	UNSPECIFIED
dwingendheid	dwingendheid	UNSPECIFIED
overtuigdheid	overtuigdheid	UNSPECIFIED
sprekendheid	sprekendheid	UNSPECIFIED
afwijkendheid	afwijkendheid	UNSPECIFIED
berekendheid	berekendheid	UNSPECIFIED
berekenendheid	berekenendheid	UNSPECIFIED
fietsbaarheid	fietsbaarheid	UNSPECIFIED
nadenkendheid	nadenkendheid	UNSPECIFIED
dronkenheid	dronkenheid	UNSPECIFIED
hitserigheid	hitserigheid	UNSPECIFIED
koehakkigheid	koehakkigheid	UNSPECIFIED
veellagigheid	veellagigheid	UNSPECIFIED
valsigheid	valsigheid	UNSPECIFIED
nageeflijkheid	nageeflijkheid	UNSPECIFIED
rookwerendheid	rookwerendheid	UNSPECIFIED
wattenbollen	wattenbol	UNSPECIFIED
